kick_result,kick_distance,game_seconds_remaining,total_home_score,total_away_score,home_team,away_team,posteam_score,defteam_score,score_differential
1,21,3003,0,3,PHI,ATL,0,0,0
1,26,2172,3,3,PHI,ATL,0,3,-3
1,52,1933,3,6,PHI,ATL,3,3,0
1,41,2598,17,0,BAL,BUF,14,0,14
0,52,2328,17,0,BAL,BUF,0,17,-17
1,39,2060,20,0,BAL,BUF,17,0,17
1,35,1062,40,3,BAL,BUF,0,40,-40
1,39,3317,0,3,NYG,JAX,0,0,0
1,27,2726,3,3,NYG,JAX,0,3,-3
1,39,2242,3,6,NYG,JAX,3,3,0
1,31,1807,6,13,NYG,JAX,3,13,-10
1,44,1463,9,13,NYG,JAX,6,13,-7
1,36,2970,10,7,NO,TB,7,7,0
1,33,2477,17,17,NO,TB,14,17,-3
1,36,1589,24,33,NO,TB,30,24,6
0,44,297,32,47,NO,TB,47,32,15
1,42,2857,7,3,NE,HOU,0,7,-7
1,36,2343,14,6,NE,HOU,3,14,-11
1,39,1265,24,6,NE,HOU,21,6,15
1,35,593,27,13,NE,HOU,24,13,11
1,48,2940,3,0,MIN,SF,0,0,0
1,42,2507,10,3,MIN,SF,0,10,-10
1,33,1458,16,6,MIN,SF,3,16,-13
1,22,493,23,16,MIN,SF,13,23,-10
1,47,3322,0,3,MIA,TEN,0,0,0
1,27,1149,10,3,MIA,TEN,7,3,4
1,30,233,27,17,MIA,TEN,24,17,7
1,53,16,27,20,MIA,TEN,17,27,-10
1,42,3205,0,3,IND,CIN,0,0,0
1,21,2787,3,3,IND,CIN,0,3,-3
1,38,1986,13,3,IND,CIN,10,3,7
1,51,1806,16,10,IND,CIN,13,10,3
0,55,917,23,17,IND,CIN,23,17,6
1,39,241,23,27,IND,CIN,24,23,1
0,42,107,21,21,CLE,PIT,21,21,0
0,43,13,21,21,CLE,PIT,21,21,0
1,45,3264,3,6,LAC,KC,0,6,-6
1,39,2725,6,13,LAC,KC,3,13,-10
1,46,1924,12,16,LAC,KC,13,12,1
0,48,71,28,37,LAC,KC,28,37,-9
1,35,2643,7,10,DEN,SEA,7,7,0
1,51,2129,17,10,DEN,SEA,14,10,4
0,46,1916,17,10,DEN,SEA,10,17,-7
1,53,1026,20,17,DEN,SEA,17,17,0
1,27,1807,10,0,CAR,DAL,7,0,7
0,47,1064,10,0,CAR,DAL,0,10,-10
1,31,736,0,24,ARI,WAS,21,0,21
1,26,2700,0,10,GB,CHI,7,0,7
1,33,1458,0,19,GB,CHI,16,0,16
1,42,1121,3,19,GB,CHI,0,19,-19
1,32,162,17,22,GB,CHI,19,17,2
1,35,2700,6,10,DET,NYJ,7,6,1
0,55,2368,6,10,DET,NYJ,6,10,-4
1,21,1815,9,17,DET,NYJ,6,17,-11
1,32,1219,16,39,DET,NYJ,36,16,20
0,44,1011,16,39,DET,NYJ,16,39,-23
1,24,2553,10,7,OAK,LA,7,7,0
0,46,2370,10,7,OAK,LA,7,10,-3
1,20,1963,10,10,OAK,LA,7,10,-3
1,48,1815,13,10,OAK,LA,10,10,0
1,28,1447,13,13,OAK,LA,10,13,-3
1,55,564,13,23,OAK,LA,20,13,7
1,20,198,13,26,OAK,LA,23,13,10
1,55,1655,28,17,CIN,BAL,14,28,-14
1,28,183,31,23,CIN,BAL,28,23,5
1,40,149,34,23,CIN,BAL,31,23,8
1,54,3400,0,3,ATL,CAR,0,0,0
1,44,3046,3,3,ATL,CAR,0,3,-3
1,49,2476,3,7,WAS,IND,0,7,-7
0,49,1805,3,14,WAS,IND,3,14,-11
1,27,1243,6,14,WAS,IND,3,14,-11
1,49,813,9,14,WAS,IND,6,14,-8
0,54,3016,7,0,TEN,HOU,0,7,-7
1,34,1064,14,10,TEN,HOU,7,14,-7
1,42,588,17,17,TEN,HOU,14,17,-3
1,31,65,20,17,TEN,HOU,17,17,0
0,42,1807,20,7,TB,PHI,7,20,-13
0,49,3009,0,14,PIT,KC,0,14,-14
1,55,611,9,20,NYJ,MIA,6,20,-14
1,41,360,12,20,NYJ,MIA,9,20,-11
1,43,2622,3,14,BUF,LAC,0,14,-14
1,41,1852,6,28,BUF,LAC,3,28,-25
1,24,232,13,31,BUF,LAC,28,13,15
0,48,1902,14,7,GB,MIN,7,14,-7
1,37,1802,17,7,GB,MIN,14,7,7
1,40,1296,20,7,GB,MIN,17,7,10
1,31,458,23,14,GB,MIN,20,14,6
1,48,137,26,21,GB,MIN,23,21,2
1,36,109,29,21,GB,MIN,26,21,5
0,52,3,29,29,GB,MIN,29,29,0
0,49,456,29,29,GB,MIN,29,29,0
0,35,4,29,29,GB,MIN,29,29,0
1,39,3215,0,3,NO,CLE,0,0,0
1,31,2872,3,3,NO,CLE,0,3,-3
0,44,2061,3,3,NO,CLE,3,3,0
1,39,1920,3,6,NO,CLE,3,3,0
0,44,861,3,12,NO,CLE,12,3,9
1,44,26,21,18,NO,CLE,18,18,0
0,52,8,21,18,NO,CLE,18,21,-3
1,45,3082,3,0,SF,DET,0,0,0
1,42,2100,13,7,SF,DET,10,7,3
1,27,1806,13,10,SF,DET,7,13,-6
1,43,1430,20,13,SF,DET,10,20,-10
1,36,685,30,13,SF,DET,27,13,14
1,20,2291,11,0,LA,ARI,8,0,8
0,54,3409,0,0,JAX,NE,0,0,0
1,29,1969,14,3,JAX,NE,0,14,-14
1,28,1374,24,3,JAX,NE,21,3,18
1,46,856,24,13,JAX,NE,10,24,-14
1,26,3276,0,3,DEN,OAK,0,0,0
1,46,2512,0,6,DEN,OAK,3,0,3
1,39,1067,10,19,DEN,OAK,7,19,-12
1,36,10,20,19,DEN,OAK,17,19,-2
1,37,3066,10,0,DAL,NYG,7,0,7
1,29,1547,13,0,DAL,NYG,10,0,10
1,28,1174,13,3,DAL,NYG,0,13,-13
1,38,15,20,13,DAL,NYG,10,20,-10
1,25,1871,10,0,CHI,SEA,7,0,7
1,56,1802,10,3,CHI,SEA,0,10,-10
1,45,1827,3,14,CLE,NYJ,0,14,-14
1,27,1224,6,14,CLE,NYJ,3,14,-11
1,28,538,14,17,CLE,NYJ,14,14,0
1,49,2383,7,10,ATL,NO,7,7,0
1,21,1989,7,13,ATL,NO,10,7,3
1,45,1810,14,16,ATL,NO,13,14,-1
1,41,2576,14,3,WAS,GB,0,14,-14
1,35,120,31,17,WAS,GB,28,17,11
0,55,2841,7,0,PHI,IND,7,0,7
1,33,1989,10,7,PHI,IND,7,7,0
1,35,1484,10,10,PHI,IND,7,10,-3
1,31,1406,10,13,PHI,IND,10,10,0
1,24,1073,13,13,PHI,IND,10,13,-3
1,28,862,13,16,PHI,IND,13,13,0
1,30,3147,0,10,MIN,BUF,7,0,7
1,50,2181,0,27,MIN,BUF,24,0,24
1,25,2015,7,10,MIA,OAK,7,7,0
1,52,25,28,20,MIA,OAK,17,28,-11
1,52,2923,10,14,BAL,DEN,7,14,-7
0,43,2085,17,14,BAL,DEN,17,14,3
1,52,1804,20,14,BAL,DEN,17,14,3
0,53,439,28,21,CAR,CIN,21,28,-7
1,40,76,31,21,CAR,CIN,28,21,7
1,23,3313,3,0,HOU,NYG,0,0,0
1,44,2513,3,10,HOU,NYG,7,3,4
1,30,2078,3,13,HOU,NYG,10,3,7
1,28,1804,6,20,HOU,NYG,3,20,-17
1,54,1426,9,20,HOU,NYG,6,20,-14
1,39,3003,0,3,JAX,TEN,0,0,0
1,46,2339,3,3,JAX,TEN,0,3,-3
0,48,1802,3,3,JAX,TEN,3,3,0
1,36,1505,3,6,JAX,TEN,3,3,0
1,38,691,6,6,JAX,TEN,3,6,-3
1,28,253,6,9,JAX,TEN,6,6,0
1,39,1804,35,10,KC,SF,7,35,-28
1,37,831,38,24,KC,SF,35,24,11
1,35,321,38,27,KC,SF,24,38,-14
0,46,1804,20,13,LA,LAC,20,13,7
1,26,714,34,23,LA,LAC,20,34,-14
1,50,2130,7,3,SEA,DAL,0,7,-7
1,47,1804,17,3,SEA,DAL,14,3,11
1,35,1128,17,6,SEA,DAL,3,17,-14
0,46,2999,7,0,ARI,CHI,0,7,-7
1,20,1917,14,3,ARI,CHI,0,14,-14
1,41,949,14,13,ARI,CHI,10,14,-4
1,43,274,14,16,ARI,CHI,13,14,-1
1,38,3060,3,0,DET,NE,0,0,0
1,25,2102,13,0,DET,NE,10,0,10
1,36,1844,13,3,DET,NE,0,13,-13
1,32,768,23,10,DET,NE,20,10,10
1,30,120,26,10,DET,NE,23,10,13
1,38,2539,7,9,TB,PIT,6,7,-1
1,21,1877,10,22,TB,PIT,7,22,-15
1,28,1330,13,29,TB,PIT,10,29,-19
0,47,971,13,29,TB,PIT,29,13,16
1,37,2410,7,10,LA,MIN,7,7,0
1,39,1806,28,20,LA,MIN,17,28,-11
1,34,1226,31,20,LA,MIN,28,20,8
0,28,505,38,28,LA,MIN,38,28,10
1,40,230,38,31,LA,MIN,28,38,-10
1,32,2965,3,0,JAX,NYJ,0,0,0
1,22,2368,6,0,JAX,NYJ,3,0,3
1,54,1834,16,0,JAX,NYJ,13,0,13
1,27,1198,18,3,JAX,NYJ,0,18,-18
1,38,776,25,6,JAX,NYJ,3,25,-22
1,20,3030,3,0,NE,MIA,0,0,0
1,42,3386,3,0,TEN,PHI,0,0,0
1,27,1803,3,10,TEN,PHI,7,3,4
1,33,562,13,17,TEN,PHI,10,17,-7
1,30,21,20,20,TEN,PHI,17,20,-3
1,37,383,20,23,TEN,PHI,20,20,0
1,42,1806,10,21,IND,HOU,7,21,-14
1,40,182,23,31,IND,HOU,28,23,5
0,59,6,31,31,IND,HOU,31,31,0
1,44,364,34,31,IND,HOU,31,31,0
1,29,114,34,34,IND,HOU,31,34,-3
1,37,3,34,37,IND,HOU,34,34,0
1,52,1803,16,0,GB,BUF,13,0,13
1,36,1577,19,0,GB,BUF,16,0,16
1,52,120,22,0,GB,BUF,19,0,19
1,32,2974,3,0,DAL,DET,0,0,0
1,43,2466,6,7,DAL,DET,3,7,-4
1,33,1974,6,10,DAL,DET,7,6,1
1,22,352,23,17,DAL,DET,20,17,3
1,38,3,26,24,DAL,DET,23,24,-1
1,30,2700,14,3,CHI,TB,0,14,-14
1,50,1803,38,3,CHI,TB,35,3,32
1,46,388,48,10,CHI,TB,45,10,35
1,55,1802,24,28,ATL,CIN,21,28,-7
1,28,1585,27,28,ATL,CIN,24,28,-4
1,36,503,33,31,ATL,CIN,28,33,-5
1,32,258,36,31,ATL,CIN,33,31,2
0,38,2979,0,7,ARI,SEA,7,0,7
1,23,2648,3,7,ARI,SEA,0,7,-7
0,52,2129,3,7,ARI,SEA,7,3,4
0,50,1802,10,7,ARI,SEA,10,7,3
1,40,1204,10,10,ARI,SEA,7,10,-3
0,45,115,17,17,ARI,SEA,17,17,0
1,52,4,17,20,ARI,SEA,17,17,0
1,25,2823,6,3,OAK,CLE,0,6,-6
0,47,2570,6,3,OAK,CLE,6,3,3
1,28,1466,13,20,OAK,CLE,17,13,4
1,29,857,23,28,OAK,CLE,20,28,-8
1,44,650,33,28,OAK,CLE,30,28,2
0,50,374,41,42,OAK,CLE,41,42,-1
1,29,110,44,42,OAK,CLE,41,42,-1
1,42,2700,7,3,NYG,NO,0,7,-7
1,34,2243,7,6,NYG,NO,3,7,-4
1,37,2020,7,9,NYG,NO,6,7,-1
1,26,1815,7,12,NYG,NO,9,7,2
1,33,1032,10,19,NYG,NO,7,19,-12
0,54,3126,0,6,LAC,SF,0,6,-6
1,21,2102,6,16,LAC,SF,13,6,7
1,48,1804,17,16,LAC,SF,14,16,-2
1,25,1368,26,16,LAC,SF,23,16,7
1,33,763,26,26,LAC,SF,23,26,-3
1,21,464,29,26,LAC,SF,26,26,0
1,34,2650,3,14,PIT,BAL,0,14,-14
1,39,2189,6,14,PIT,BAL,3,14,-11
1,47,1143,14,17,PIT,BAL,14,14,0
1,49,707,14,20,PIT,BAL,17,14,3
1,28,220,14,23,PIT,BAL,20,14,6
1,31,120,14,26,PIT,BAL,23,14,9
1,42,3398,3,0,DEN,KC,0,0,0
1,33,3067,3,3,DEN,KC,0,3,-3
1,34,1804,13,10,DEN,KC,10,10,0
1,21,1475,13,13,DEN,KC,10,13,-3
1,46,772,23,13,DEN,KC,20,13,7
0,38,2761,7,0,NE,IND,0,7,-7
1,54,2334,14,3,NE,IND,0,14,-14
1,45,1817,24,3,NE,IND,21,3,18
1,25,2799,7,3,BUF,TEN,0,7,-7
1,54,1803,7,6,BUF,TEN,3,7,-4
1,40,1023,10,6,BUF,TEN,7,6,1
1,39,634,10,9,BUF,TEN,6,10,-4
1,50,287,10,12,BUF,TEN,9,10,-1
1,46,3,13,12,BUF,TEN,10,12,-2
1,47,2107,13,10,PIT,ATL,7,13,-6
0,30,2892,0,7,NYJ,DEN,0,7,-7
1,30,2041,14,10,NYJ,DEN,7,14,-7
1,49,1196,24,10,NYJ,DEN,21,10,11
1,30,782,27,10,NYJ,DEN,24,10,14
1,22,2613,10,0,KC,JAX,7,0,7
1,42,1920,13,0,KC,JAX,10,0,10
1,38,1230,22,0,KC,JAX,19,0,19
0,41,2906,7,0,DET,GB,0,7,-7
1,39,2692,17,0,DET,GB,14,0,14
0,42,2482,17,0,DET,GB,0,17,-17
0,38,2018,17,0,DET,GB,0,17,-17
0,55,1261,24,8,DET,GB,24,8,16
0,56,220,31,20,DET,GB,20,31,-11
1,41,7,31,23,DET,GB,20,31,-11
1,44,3221,0,3,CLE,BAL,0,0,0
0,48,1805,6,3,CLE,BAL,3,6,-3
1,35,1352,9,3,CLE,BAL,6,3,3
1,25,956,9,6,CLE,BAL,3,9,-6
1,32,56,9,9,CLE,BAL,6,9,-3
0,55,9,9,9,CLE,BAL,9,9,0
1,37,6,12,9,CLE,BAL,9,9,0
1,42,3150,0,3,CAR,NYG,0,0,0
1,47,2330,16,3,CAR,NYG,13,3,10
1,47,1961,19,10,CAR,NYG,16,10,6
1,53,1825,19,13,CAR,NYG,10,19,-9
1,36,1359,19,16,CAR,NYG,13,19,-6
1,39,141,29,24,CAR,NYG,26,24,2
1,63,6,32,31,CAR,NYG,29,31,-2
0,37,2038,0,7,CIN,MIA,0,7,-7
1,42,1470,0,16,CIN,MIA,13,0,13
1,51,1212,3,16,CIN,MIA,0,16,-16
1,20,213,19,16,CIN,MIA,16,16,0
1,49,3374,3,0,LAC,OAK,0,0,0
1,24,2607,3,3,LAC,OAK,0,3,-3
0,57,1811,17,3,LAC,OAK,3,17,-14
0,48,1800,17,3,LAC,OAK,17,3,14
1,30,1269,20,3,LAC,OAK,17,3,14
0,45,897,6,14,SF,ARI,6,14,-8
0,28,3223,0,0,PHI,MIN,0,0,0
1,37,3006,0,3,PHI,MIN,0,0,0
1,30,2547,3,3,PHI,MIN,0,3,-3
0,45,2217,3,3,PHI,MIN,3,3,0
1,22,1355,3,19,PHI,MIN,16,3,13
1,28,1080,6,19,PHI,MIN,3,19,-16
1,52,171,14,22,PHI,MIN,19,14,5
1,19,2476,7,10,SEA,LA,7,7,0
1,52,1920,17,17,SEA,LA,14,17,-3
1,39,369,31,33,SEA,LA,30,31,-1
1,27,3306,0,3,HOU,DAL,0,0,0
0,48,3052,0,3,HOU,DAL,0,3,-3
1,43,2893,0,6,HOU,DAL,3,0,3
1,20,2163,10,6,HOU,DAL,7,6,1
1,21,1205,13,13,HOU,DAL,10,13,-3
1,19,514,16,13,HOU,DAL,13,13,0
1,48,343,16,16,HOU,DAL,13,16,-3
1,36,115,19,16,HOU,DAL,16,16,0
1,37,2862,6,3,NO,WAS,0,6,-6
1,53,2321,13,6,NO,WAS,3,13,-10
1,44,855,43,13,NO,WAS,40,13,27
1,33,3309,3,7,NYG,PHI,0,7,-7
1,21,2148,6,14,NYG,PHI,3,14,-11
1,33,1894,6,24,NYG,PHI,21,6,15
0,52,1828,6,24,NYG,PHI,6,24,-18
0,54,1807,6,24,NYG,PHI,24,6,18
1,30,896,13,34,NYG,PHI,31,13,18
1,45,1806,24,13,ATL,TB,21,13,8
1,35,1063,24,16,ATL,TB,13,24,-11
1,57,76,34,29,ATL,TB,31,29,2
1,49,2135,17,0,WAS,CAR,14,0,14
1,32,1212,17,9,WAS,CAR,6,17,-11
1,56,766,20,9,WAS,CAR,17,9,8
1,29,198,23,17,WAS,CAR,20,17,3
0,48,2182,0,14,OAK,SEA,0,14,-14
1,44,1804,0,17,OAK,SEA,14,0,14
1,26,1605,0,20,OAK,SEA,17,0,17
1,43,510,3,27,OAK,SEA,0,27,-27
1,30,2975,9,7,NYJ,IND,6,7,-1
1,21,2607,9,10,NYJ,IND,7,9,-2
1,31,2487,9,13,NYJ,IND,10,9,1
1,48,1889,19,13,NYJ,IND,16,13,3
1,32,1803,22,13,NYJ,IND,19,13,6
1,37,1137,32,20,NYJ,IND,29,20,9
1,45,584,35,27,NYJ,IND,32,27,5
1,37,358,38,27,NYJ,IND,35,27,8
1,45,202,41,27,NYJ,IND,38,27,11
1,26,3202,0,3,MIN,ARI,0,0,0
1,37,2828,10,3,MIN,ARI,7,3,4
1,48,1812,13,9,MIN,ARI,10,9,1
1,21,1316,14,17,CIN,PIT,14,14,0
1,24,215,14,20,CIN,PIT,17,14,3
1,33,2570,3,7,CLE,LAC,0,7,-7
1,28,1803,6,21,CLE,LAC,3,21,-18
1,44,259,14,38,CLE,LAC,35,14,21
1,33,2317,10,0,HOU,BUF,7,0,7
1,23,1515,10,3,HOU,BUF,0,10,-10
1,52,1038,10,6,HOU,BUF,3,10,-7
1,27,97,13,13,HOU,BUF,10,13,-3
1,50,1375,10,14,MIA,CHI,7,14,-7
1,25,930,13,21,MIA,CHI,10,21,-11
0,53,120,28,28,MIA,CHI,28,28,0
1,47,3,31,28,MIA,CHI,28,28,0
1,26,3387,0,3,DEN,LA,0,0,0
1,39,2965,0,6,DEN,LA,3,0,3
1,28,2707,3,6,DEN,LA,0,6,-6
0,47,619,10,20,DEN,LA,20,10,10
1,24,537,13,20,DEN,LA,10,20,-10
1,21,199,13,23,DEN,LA,20,13,7
1,50,3220,3,0,DAL,JAX,0,0,0
1,46,1089,27,7,DAL,JAX,24,7,17
1,32,982,30,7,DAL,JAX,27,7,20
1,55,432,40,7,DAL,JAX,37,7,30
1,42,3249,0,3,NE,KC,0,0,0
1,48,3022,3,3,NE,KC,0,3,-3
1,43,2909,10,6,NE,KC,3,10,-7
1,24,2184,17,9,NE,KC,6,17,-11
1,24,1340,27,16,NE,KC,24,16,8
1,30,1120,27,19,NE,KC,16,27,-11
1,39,625,30,26,NE,KC,27,26,1
1,50,199,40,33,NE,KC,37,33,4
1,28,3,43,40,NE,KC,40,40,0
1,29,3162,10,7,GB,SF,7,7,0
1,39,2258,20,14,GB,SF,17,14,3
1,46,1804,20,24,GB,SF,21,20,1
1,51,1581,23,24,GB,SF,20,24,-4
1,44,1324,23,27,GB,SF,24,23,1
1,43,792,23,30,GB,SF,27,23,4
1,27,3,33,30,GB,SF,30,30,0
1,43,3023,3,13,ARI,DEN,0,13,-13
1,41,339,10,43,ARI,DEN,40,10,30
1,28,3287,0,3,LAC,TEN,0,0,0
1,29,2811,10,3,LAC,TEN,7,3,4
1,33,2575,10,6,LAC,TEN,3,10,-7
1,28,753,20,13,LAC,TEN,17,13,4
0,51,506,20,13,LAC,TEN,13,20,-7
1,44,3327,0,3,JAX,HOU,0,0,0
1,48,2904,0,6,JAX,HOU,3,0,3
0,36,2870,0,0,PHI,CAR,0,0,0
1,46,2200,10,0,PHI,CAR,7,0,7
1,26,2416,7,10,NYJ,MIN,7,7,0
0,42,1847,7,10,NYJ,MIN,10,7,3
1,22,1252,7,20,NYJ,MIN,17,7,10
1,55,1064,10,20,NYJ,MIN,7,20,-13
1,43,206,17,37,NYJ,MIN,34,17,17
1,46,2935,3,7,CHI,NE,0,7,-7
1,29,1372,24,24,CHI,NE,21,24,-3
1,36,1803,24,0,IND,BUF,21,0,21
1,34,1366,24,3,IND,BUF,0,24,-24
1,38,2884,3,2,TB,CLE,0,2,-2
0,40,4,23,23,TB,CLE,23,23,0
1,59,115,26,23,TB,CLE,23,23,0
1,29,2559,0,10,MIA,DET,7,0,7
1,28,1416,7,20,MIA,DET,17,7,10
1,35,609,14,29,MIA,DET,26,14,12
1,50,120,21,32,MIA,DET,29,21,8
0,46,53,21,32,MIA,DET,21,32,-11
1,31,2167,3,0,BAL,NO,0,0,0
1,39,135,17,24,BAL,NO,21,17,4
1,21,1453,10,7,WAS,DAL,7,7,0
1,25,758,13,7,WAS,DAL,10,7,3
1,47,590,13,10,WAS,DAL,7,13,-6
0,52,3,19,17,WAS,DAL,17,19,-2
1,35,3098,0,3,SF,LA,0,0,0
1,37,2408,0,15,SF,LA,12,0,12
1,33,1389,7,25,SF,LA,22,7,15
1,51,1062,10,32,SF,LA,7,32,-25
0,53,2744,7,0,KC,CIN,7,0,7
1,26,1811,24,7,KC,CIN,21,7,14
1,33,1280,37,10,KC,CIN,7,37,-30
1,31,1854,7,3,ATL,NYG,0,7,-7
1,40,1808,10,3,ATL,NYG,7,3,4
1,36,1135,10,6,ATL,NYG,3,10,-7
1,50,900,13,6,ATL,NYG,10,6,4
1,56,120,23,12,ATL,NYG,20,12,8
1,37,1981,14,10,HOU,MIA,7,14,-7
1,41,939,28,20,HOU,MIA,17,28,-11
1,46,690,35,23,HOU,MIA,20,35,-15
1,50,3116,3,0,JAX,PHI,0,0,0
1,31,2266,3,3,JAX,PHI,0,3,-3
1,57,1968,6,3,JAX,PHI,3,3,0
1,33,794,15,17,JAX,PHI,12,17,-5
1,24,420,18,24,JAX,PHI,15,24,-9
1,24,2841,3,7,KC,DEN,0,7,-7
0,55,2506,3,7,KC,DEN,7,3,4
1,36,112,30,23,KC,DEN,20,30,-10
1,34,3255,0,3,PIT,CLE,0,0,0
1,45,2858,0,6,PIT,CLE,3,0,3
0,41,2613,0,6,PIT,CLE,6,0,6
1,42,813,26,12,PIT,CLE,23,12,11
0,41,2003,0,7,NYG,WAS,7,0,7
1,37,1879,3,7,NYG,WAS,0,7,-7
1,53,1196,3,10,NYG,WAS,7,3,4
1,39,597,3,13,NYG,WAS,10,3,7
1,21,251,6,13,NYG,WAS,3,13,-10
1,25,1806,27,9,CIN,TB,6,27,-21
1,38,779,33,19,CIN,TB,16,33,-17
1,44,5,36,34,CIN,TB,33,34,-1
0,40,3183,0,0,CHI,NYJ,0,0,0
1,42,2523,7,3,CHI,NYJ,0,7,-7
1,32,900,17,3,CHI,NYJ,14,3,11
1,54,1802,24,7,CAR,BAL,21,7,14
1,44,1083,27,7,CAR,BAL,24,7,17
1,30,194,36,14,CAR,BAL,33,14,19
1,26,2703,0,10,OAK,IND,7,0,7
1,25,1829,14,13,OAK,IND,10,14,-4
1,31,2427,3,2,ARI,SF,0,2,-2
1,27,2076,3,5,ARI,SF,2,3,-1
1,20,817,3,15,ARI,SF,12,3,9
1,41,2663,0,10,LA,GB,7,0,7
1,53,1483,8,13,LA,GB,10,8,2
1,43,704,26,20,LA,GB,23,20,3
1,34,129,29,27,LA,GB,26,27,-1
1,52,2252,13,10,MIN,NO,7,13,-6
1,42,1402,13,20,MIN,NO,17,13,4
1,42,579,13,29,MIN,NO,26,13,13
1,25,2989,0,3,BUF,NE,0,0,0
1,40,2511,0,6,BUF,NE,3,0,3
1,38,2146,0,9,BUF,NE,6,0,6
1,47,1904,3,9,BUF,NE,0,9,-9
0,50,1810,3,9,BUF,NE,9,3,6
1,51,1362,6,9,BUF,NE,3,9,-6
1,25,1026,6,12,BUF,NE,9,6,3
1,37,3274,0,3,SF,OAK,0,0,0
1,39,1821,17,3,SF,OAK,14,3,11
0,45,806,31,3,SF,OAK,3,31,-28
1,25,243,34,3,SF,OAK,31,3,28
1,41,1566,3,26,BUF,CHI,0,26,-26
1,23,1396,3,29,BUF,CHI,26,3,23
1,45,818,3,32,BUF,CHI,29,3,26
1,51,2865,3,7,CLE,KC,0,7,-7
1,39,570,21,37,CLE,KC,34,21,13
1,43,2564,3,0,MIA,NYJ,0,0,0
1,27,1874,6,0,MIA,NYJ,3,0,3
1,48,1825,6,3,MIA,NYJ,0,6,-6
0,50,765,6,3,MIA,NYJ,3,6,-3
1,56,363,12,6,MIA,NYJ,3,12,-9
1,23,3005,3,0,BAL,PIT,0,0,0
1,23,2080,6,14,BAL,PIT,3,14,-11
1,29,509,13,23,BAL,PIT,20,13,7
1,37,327,16,23,BAL,PIT,13,23,-10
1,35,2600,7,3,MIN,DET,0,7,-7
1,35,2088,7,6,MIN,DET,3,7,-4
1,39,1808,17,6,MIN,DET,14,6,8
1,37,73,23,9,MIN,DET,6,23,-17
1,27,433,14,31,WAS,ATL,28,14,14
1,44,2987,3,7,DEN,HOU,0,7,-7
0,62,1822,10,13,DEN,HOU,10,13,-3
1,46,1803,10,16,DEN,HOU,13,10,3
1,37,851,17,19,DEN,HOU,16,17,-1
0,51,3,17,19,DEN,HOU,17,19,-2
0,51,2155,7,12,SEA,LAC,7,12,-5
1,44,1804,10,19,SEA,LAC,7,19,-12
0,42,1338,10,19,SEA,LAC,19,10,9
0,51,2015,21,14,NO,LA,14,21,-7
1,56,1802,35,17,NO,LA,14,35,-21
1,34,994,35,27,NO,LA,24,35,-11
1,54,388,38,35,NO,LA,35,35,0
1,29,3008,7,3,NE,GB,0,7,-7
1,28,2612,10,3,NE,GB,7,3,4
0,38,3335,0,0,DAL,TEN,0,0,0
0,28,662,14,21,DAL,TEN,21,14,7
1,50,2391,23,7,PIT,CAR,20,7,13
1,29,1448,7,38,CIN,NO,35,7,28
1,42,685,7,48,CIN,NO,45,7,38
1,41,442,7,51,CIN,NO,48,7,41
1,40,2542,7,3,CLE,ATL,0,7,-7
1,52,1708,26,10,CHI,DET,7,26,-19
0,41,1573,26,10,CHI,DET,26,10,16
0,34,1428,26,10,CHI,DET,26,10,16
1,45,2885,10,7,KC,ARI,7,7,0
1,46,2555,13,7,KC,ARI,10,7,3
1,52,3264,7,3,TEN,NE,0,7,-7
1,33,2859,17,3,TEN,NE,14,3,11
0,52,2368,17,10,TEN,NE,10,17,-7
1,31,1159,27,10,TEN,NE,24,10,14
1,43,2714,0,3,TB,WAS,0,0,0
0,30,2315,0,3,TB,WAS,0,3,-3
1,33,1926,3,3,TB,WAS,0,3,-3
1,43,1824,3,6,TB,WAS,3,3,0
0,48,1152,3,6,TB,WAS,3,6,-3
1,26,726,3,16,TB,WAS,13,3,10
1,54,2637,0,17,NYJ,BUF,14,0,14
1,55,1802,3,31,NYJ,BUF,0,31,-31
1,31,167,10,41,NYJ,BUF,38,10,28
1,28,1809,29,16,IND,JAX,13,29,-16
0,52,962,29,23,IND,JAX,23,29,-6
1,55,248,29,26,IND,JAX,23,29,-6
0,52,178,29,26,IND,JAX,29,26,3
1,46,2876,3,0,OAK,LAC,0,0,0
1,27,2150,3,3,OAK,LAC,0,3,-3
1,30,893,6,17,OAK,LAC,3,17,-14
1,41,436,6,20,OAK,LAC,17,6,11
1,35,2693,10,14,LA,SEA,7,14,-7
1,37,1489,20,14,LA,SEA,17,14,3
1,33,596,26,24,LA,SEA,21,26,-5
1,20,459,29,24,LA,SEA,26,24,2
1,37,2782,7,3,GB,MIA,0,7,-7
1,25,2433,14,6,GB,MIA,3,14,-11
1,47,1974,14,9,GB,MIA,6,14,-8
1,40,1603,14,12,GB,MIA,9,14,-5
1,38,537,31,12,GB,MIA,28,12,16
1,25,3122,0,3,PHI,DAL,0,0,0
1,31,2025,0,6,PHI,DAL,3,0,3
1,56,1898,3,6,PHI,DAL,0,6,-6
1,26,1479,6,13,PHI,DAL,3,13,-10
0,42,1363,6,13,PHI,DAL,13,6,7
1,53,3318,3,0,SF,NYG,0,0,0
1,20,1913,10,10,SF,NYG,7,10,-3
1,36,1807,13,10,SF,NYG,10,10,0
1,31,1034,20,20,SF,NYG,17,20,-3
1,30,170,23,20,SF,NYG,20,20,0
0,47,3351,0,7,SEA,GB,7,0,7
1,39,3064,3,7,SEA,GB,0,7,-7
1,43,738,20,21,SEA,GB,17,21,-4
1,36,507,20,24,SEA,GB,21,20,1
1,28,1907,10,7,BAL,CIN,7,7,0
1,56,1805,13,7,BAL,CIN,10,7,3
1,24,495,24,21,BAL,CIN,21,21,0
0,52,244,24,21,BAL,CIN,21,24,-3
1,21,2880,0,3,ATL,DAL,0,0,0
1,41,2696,3,3,ATL,DAL,0,3,-3
1,45,1834,6,3,ATL,DAL,3,3,0
1,50,1520,6,6,ATL,DAL,3,6,-3
1,53,1336,9,6,ATL,DAL,6,6,0
1,21,508,12,19,ATL,DAL,9,19,-10
1,42,3,19,22,ATL,DAL,19,19,0
1,52,1329,23,7,NYG,TB,20,7,13
1,48,2595,3,0,JAX,PIT,0,0,0
1,38,2314,6,0,JAX,PIT,3,0,3
1,43,2021,9,0,JAX,PIT,6,0,6
1,23,3275,0,3,WAS,HOU,0,0,0
0,44,1836,7,16,WAS,HOU,16,7,9
1,33,982,14,19,WAS,HOU,16,14,2
1,54,455,21,22,WAS,HOU,19,21,-2
0,45,56,21,22,WAS,HOU,22,21,1
0,63,8,21,22,WAS,HOU,21,22,-1
1,22,2464,10,0,IND,TEN,7,0,7
1,42,1803,24,3,IND,TEN,0,24,-24
1,54,1842,10,7,DET,CAR,7,7,0
0,34,1456,10,7,DET,CAR,7,10,-3
1,32,1131,13,7,DET,CAR,10,7,3
1,46,3125,3,0,LAC,DEN,0,0,0
1,45,2745,6,0,LAC,DEN,3,0,3
1,30,411,22,20,LAC,DEN,19,20,-1
1,34,3,22,23,LAC,DEN,20,22,-2
1,49,1531,14,17,ARI,OAK,14,14,0
1,21,925,14,20,ARI,OAK,17,14,3
1,35,2,21,23,ARI,OAK,20,21,-1
1,38,3256,3,0,NO,PHI,0,0,0
1,19,409,48,7,NO,PHI,45,7,38
1,33,3062,3,0,CHI,MIN,0,0,0
1,41,1855,14,0,CHI,MIN,11,0,11
1,36,911,14,3,CHI,MIN,0,14,-14
1,36,711,14,6,CHI,MIN,3,14,-11
1,48,172,23,14,CHI,MIN,20,14,6
1,23,2698,16,7,LA,KC,13,7,6
1,21,2289,16,10,LA,KC,7,16,-9
1,33,1049,32,30,LA,KC,29,30,-1
1,40,2043,7,3,DET,CHI,0,7,-7
1,20,468,16,16,DET,CHI,13,16,-3
1,28,1892,10,7,DAL,WAS,7,7,0
1,31,77,31,23,DAL,WAS,20,31,-11
1,32,2860,7,3,NO,ATL,0,7,-7
1,22,2352,10,3,NO,ATL,7,3,4
0,54,2886,0,7,CIN,CLE,0,7,-7
1,41,2003,10,6,TB,SF,7,6,1
1,39,1809,13,6,TB,SF,10,6,4
1,23,1565,13,9,TB,SF,6,13,-7
0,42,939,14,14,BUF,JAX,14,14,0
1,22,189,24,14,BUF,JAX,21,14,7
1,47,2972,3,7,BAL,OAK,0,7,-7
1,28,2234,12,7,BAL,OAK,9,7,2
1,42,1958,12,10,BAL,OAK,7,12,-5
1,26,2835,3,0,CAR,SEA,0,0,0
1,33,2565,3,3,CAR,SEA,0,3,-3
1,25,1801,13,10,CAR,SEA,10,10,0
1,30,572,20,20,CAR,SEA,17,20,-3
0,52,105,27,27,CAR,SEA,27,27,0
1,31,4,27,30,CAR,SEA,27,27,0
1,34,1950,7,10,NYJ,NE,7,7,0
1,55,1808,10,10,NYJ,NE,7,10,-3
1,32,1417,10,13,NYJ,NE,10,10,0
1,38,1144,13,13,NYJ,NE,10,13,-3
1,25,2895,0,9,PHI,NYG,6,0,6
1,51,2378,0,12,PHI,NYG,9,0,9
1,42,2122,3,12,PHI,NYG,0,12,-12
1,28,1311,14,19,PHI,NYG,11,19,-8
1,29,352,22,22,PHI,NYG,19,22,-3
1,43,25,25,22,PHI,NYG,22,22,0
1,30,2966,0,10,LAC,ARI,7,0,7
0,46,2385,7,10,LAC,ARI,10,7,3
1,31,208,45,10,LAC,ARI,42,10,32
1,29,1458,14,17,IND,MIA,14,14,0
0,48,1116,14,17,IND,MIA,14,17,-3
1,46,511,17,24,IND,MIA,14,24,-10
1,32,3,27,24,IND,MIA,24,24,0
0,48,3284,0,0,DEN,PIT,0,0,0
1,41,3091,3,0,DEN,PIT,0,0,0
1,41,2194,3,3,DEN,PIT,0,3,-3
0,48,2080,14,14,MIN,GB,14,14,0
0,56,1803,14,14,MIN,GB,14,14,0
1,37,1111,17,14,MIN,GB,14,14,0
1,38,145,24,17,MIN,GB,14,24,-10
1,31,3410,0,3,HOU,TEN,0,0,0
1,43,1801,24,10,HOU,TEN,21,10,11
1,47,1438,27,10,HOU,TEN,24,10,14
1,26,3267,3,0,DAL,NO,0,0,0
1,46,1855,13,0,DAL,NO,10,0,10
1,33,1503,13,3,DAL,NO,0,13,-13
1,44,3276,3,0,ATL,BAL,0,0,0
1,41,1810,9,10,ATL,BAL,7,9,-2
1,21,1502,9,13,ATL,BAL,10,9,1
1,45,936,9,16,ATL,BAL,13,9,4
1,47,449,9,19,ATL,BAL,16,9,7
1,35,3104,10,0,TB,CAR,7,0,7
1,37,1562,17,10,TB,CAR,7,17,-10
1,57,1801,9,14,NYG,CHI,6,14,-8
1,36,569,23,17,NYG,CHI,14,23,-9
1,37,113,26,17,NYG,CHI,23,17,6
1,21,75,26,20,NYG,CHI,17,26,-9
1,44,360,29,27,NYG,CHI,26,27,-1
1,32,1446,14,9,MIA,BUF,6,14,-8
0,55,220,21,17,MIA,BUF,17,21,-4
1,30,1933,3,0,JAX,IND,0,0,0
1,37,705,6,0,JAX,IND,3,0,3
1,35,3195,3,0,HOU,CLE,0,0,0
1,42,2004,19,0,HOU,CLE,16,0,16
1,48,1805,22,0,HOU,CLE,19,0,19
1,53,1231,25,7,HOU,CLE,22,7,15
1,38,350,28,7,HOU,CLE,25,7,18
0,50,2247,0,0,CIN,DEN,0,0,0
1,35,1816,3,7,CIN,DEN,0,7,-7
1,29,27,10,24,CIN,DEN,21,10,11
1,24,2900,0,3,DET,LA,0,0,0
1,28,2546,3,3,DET,LA,0,3,-3
1,47,1848,3,13,DET,LA,10,3,7
1,29,1381,6,13,DET,LA,3,13,-10
1,48,1251,6,16,DET,LA,13,6,7
1,35,177,16,23,DET,LA,13,23,-10
1,32,1818,10,7,GB,ARI,7,7,0
1,44,1222,10,10,GB,ARI,7,10,-3
1,44,105,17,20,GB,ARI,17,17,0
0,49,3,17,20,GB,ARI,17,20,-3
1,29,3165,0,10,OAK,KC,7,0,7
1,50,2227,0,13,OAK,KC,10,0,10
1,50,1570,10,19,OAK,KC,7,19,-12
1,44,34,33,40,OAK,KC,30,40,-10
1,54,3280,0,3,TEN,NYJ,0,0,0
1,34,2505,0,12,TEN,NYJ,9,0,9
1,43,1976,0,15,TEN,NYJ,12,0,12
1,39,1543,6,18,TEN,NYJ,15,6,9
1,39,931,13,21,TEN,NYJ,18,13,5
1,24,573,16,21,TEN,NYJ,13,21,-8
1,33,344,19,21,TEN,NYJ,16,21,-5
1,45,1805,20,3,SEA,SF,0,20,-20
1,40,473,37,16,SEA,SF,34,16,18
0,48,3031,7,0,NE,MIN,0,7,-7
1,20,2148,10,0,NE,MIN,7,0,7
0,48,1286,10,7,NE,MIN,10,7,3
1,39,1044,10,10,NE,MIN,7,10,-3
0,52,3384,0,0,PIT,LAC,0,0,0
1,48,1965,16,7,PIT,LAC,13,7,6
1,29,0,30,31,PIT,LAC,28,30,-2
1,44,2629,7,3,PHI,WAS,0,7,-7
1,47,1819,14,13,PHI,WAS,10,14,-4
1,46,705,25,13,PHI,WAS,22,13,9
1,44,292,28,13,PHI,WAS,25,13,12
1,33,1810,18,0,TEN,JAX,15,0,15
1,47,2979,7,3,BUF,NYJ,0,7,-7
1,21,2473,14,6,BUF,NYJ,3,14,-11
1,31,2238,17,6,BUF,NYJ,14,6,8
0,49,1804,17,13,BUF,NYJ,17,13,4
1,29,1706,20,13,BUF,NYJ,17,13,4
0,54,474,20,20,BUF,NYJ,20,20,0
1,36,155,23,20,BUF,NYJ,20,20,0
1,35,2443,0,9,WAS,NYG,6,0,6
1,23,1804,0,33,WAS,NYG,30,0,30
0,46,2480,7,0,TB,NO,7,0,7
1,30,2229,7,3,TB,NO,0,7,-7
0,40,1674,14,3,TB,NO,14,3,11
1,36,75,14,28,TB,NO,25,14,11
0,42,1286,21,27,MIA,NE,27,21,6
1,32,410,28,30,MIA,NE,27,28,-1
1,22,21,28,33,MIA,NE,30,28,2
0,51,2502,7,7,KC,BAL,7,7,0
1,28,2225,7,10,KC,BAL,7,7,0
1,24,1804,17,10,KC,BAL,14,10,4
0,43,3,24,24,KC,BAL,24,24,0
1,35,286,27,24,KC,BAL,24,24,0
1,54,1804,7,17,HOU,IND,14,7,7
0,53,2742,7,7,GB,ATL,7,7,0
1,50,2265,10,7,GB,ATL,7,7,0
1,48,1804,19,7,GB,ATL,16,7,9
1,30,2047,14,17,CLE,CAR,14,14,0
1,49,1863,17,17,CLE,CAR,14,17,-3
1,34,1335,17,20,CLE,CAR,17,17,0
1,41,531,26,20,CLE,CAR,23,20,3
1,40,3328,3,0,SF,DEN,0,0,0
1,29,2584,6,0,SF,DEN,3,0,3
1,47,3088,7,3,LAC,CIN,0,7,-7
1,23,2105,14,6,LAC,CIN,3,14,-11
1,59,1800,17,12,LAC,CIN,14,12,2
1,31,1362,20,12,LAC,CIN,17,12,5
1,46,737,20,15,LAC,CIN,12,20,-8
1,32,470,23,15,LAC,CIN,20,15,5
1,45,54,26,21,LAC,CIN,23,21,2
1,47,2380,0,3,ARI,DET,0,0,0
0,54,2122,0,3,ARI,DET,0,3,-3
1,22,498,3,9,ARI,DET,0,9,-9
1,44,2288,10,7,OAK,PIT,7,7,0
0,39,2073,10,7,OAK,PIT,7,10,-3
0,40,5,24,21,OAK,PIT,21,24,-3
1,28,2848,3,0,DAL,PHI,0,0,0
0,45,1913,3,0,DAL,PHI,3,0,3
1,62,1801,6,0,DAL,PHI,3,0,3
1,21,1441,9,0,DAL,PHI,6,0,6
1,26,735,9,9,DAL,PHI,6,9,-3
1,27,3256,0,3,CHI,LA,0,0,0
1,39,2873,3,3,CHI,LA,0,3,-3
1,31,2368,6,3,CHI,LA,3,3,0
1,50,2057,6,6,CHI,LA,3,6,-3
0,40,616,15,6,CHI,LA,6,15,-9
0,38,170,15,6,CHI,LA,15,6,9
1,37,2655,3,0,SEA,MIN,0,0,0
1,35,806,6,0,SEA,MIN,3,0,3
0,47,346,6,0,SEA,MIN,0,6,-6
1,41,3267,0,3,NYJ,HOU,0,0,0
1,26,2824,3,3,NYJ,HOU,0,3,-3
1,32,2574,3,6,NYJ,HOU,3,3,0
1,53,2079,3,16,NYJ,HOU,13,3,10
1,49,757,15,19,NYJ,HOU,16,15,1
1,40,57,22,29,NYJ,HOU,26,22,4
1,44,2301,10,7,DEN,CLE,7,7,0
1,40,2097,10,10,DEN,CLE,7,10,-3
1,42,1005,13,10,DEN,CLE,10,10,0
1,29,279,16,17,DEN,CLE,13,17,-4
1,41,2251,7,3,CHI,GB,0,7,-7
1,43,1470,14,6,CHI,GB,3,14,-11
1,24,406,24,14,CHI,GB,21,14,7
1,45,15,24,17,CHI,GB,14,24,-10
0,48,355,14,13,BUF,DET,13,14,-1
1,21,1910,7,9,BAL,TB,6,7,-1
1,24,1813,10,9,BAL,TB,7,9,-2
1,28,1246,17,12,BAL,TB,9,17,-8
1,35,817,20,12,BAL,TB,17,12,5
1,22,2741,9,7,ATL,ARI,6,7,-1
1,33,2121,19,7,ATL,ARI,16,7,9
1,34,2206,17,0,CIN,OAK,14,0,14
1,38,1904,20,7,CIN,OAK,17,7,10
1,50,1293,20,10,CIN,OAK,7,20,-13
1,27,1062,20,13,CIN,OAK,10,20,-10
1,23,649,23,13,CIN,OAK,20,13,7
1,40,309,23,16,CIN,OAK,13,23,-10
0,48,3390,0,0,NYG,TEN,0,0,0
1,22,309,0,17,NYG,TEN,14,0,14
1,25,1818,21,9,MIN,MIA,6,21,-15
1,36,1424,24,16,MIN,MIA,21,16,5
1,34,785,27,16,MIN,MIA,24,16,8
1,46,2815,0,3,JAX,WAS,0,0,0
1,33,2006,3,3,JAX,WAS,0,3,-3
1,33,1357,9,6,JAX,WAS,3,9,-6
1,41,681,12,6,JAX,WAS,9,6,3
1,36,4,12,16,JAX,WAS,13,12,1
0,48,3302,0,0,IND,DAL,0,0,0
1,43,1802,10,0,IND,DAL,7,0,7
1,44,1001,20,0,IND,DAL,17,0,17
1,23,421,23,0,IND,DAL,20,0,20
1,28,1870,17,13,SF,SEA,14,13,1
1,33,1079,20,13,SF,SEA,17,13,4
1,45,596,23,20,SF,SEA,20,20,0
1,48,327,23,23,SF,SEA,20,23,-3
1,36,191,26,23,SF,SEA,23,23,0
0,32,1416,14,7,PIT,NE,14,7,7
1,33,920,14,10,PIT,NE,7,14,-7
1,48,154,17,10,PIT,NE,14,10,4
1,51,3221,0,3,LA,PHI,0,0,0
1,34,2525,7,6,LA,PHI,3,7,-4
1,41,2081,10,6,LA,PHI,7,6,1
1,36,1804,13,13,LA,PHI,10,13,-3
1,40,1097,13,23,LA,PHI,20,13,7
1,37,568,16,30,LA,PHI,13,30,-17
0,53,73,23,30,LA,PHI,30,23,7
1,46,2840,7,3,CAR,NO,0,7,-7
1,24,2400,7,6,CAR,NO,3,7,-4
1,50,3434,0,3,TEN,WAS,0,0,0
1,42,1801,9,10,TEN,WAS,6,10,-4
1,40,1201,9,13,TEN,WAS,10,9,1
1,33,900,12,13,TEN,WAS,9,13,-4
1,46,494,12,16,TEN,WAS,13,12,1
1,24,3467,0,3,LAC,BAL,0,0,0
0,53,3124,0,3,LAC,BAL,3,0,3
1,35,1974,0,6,LAC,BAL,3,0,3
1,38,1845,3,6,LAC,BAL,0,6,-6
0,65,1803,3,6,LAC,BAL,6,3,3
1,56,1241,10,16,LAC,BAL,13,10,3
1,37,1814,16,0,CLE,CIN,13,0,13
1,51,900,23,3,CLE,CIN,0,23,-23
1,31,449,26,3,CLE,CIN,23,3,20
1,37,3432,0,3,DAL,TB,0,0,0
1,45,2359,13,6,DAL,TB,3,13,-10
1,59,1908,16,6,DAL,TB,13,6,7
0,52,1545,16,13,DAL,TB,13,16,-3
1,20,1124,19,13,DAL,TB,16,13,3
1,47,3155,3,0,DET,MIN,0,0,0
1,35,2443,6,0,DET,MIN,3,0,3
1,48,2050,9,0,DET,MIN,6,0,6
1,24,1437,9,17,DET,MIN,14,9,5
1,29,259,9,27,DET,MIN,24,9,15
0,43,2713,7,0,NE,BUF,0,7,-7
1,35,1713,14,3,NE,BUF,0,14,-14
1,41,1511,14,6,NE,BUF,3,14,-11
1,24,467,24,6,NE,BUF,21,6,15
0,45,3383,0,0,NYJ,GB,0,0,0
1,42,1806,21,17,NYJ,GB,14,21,-7
1,29,1400,21,20,NYJ,GB,17,21,-4
1,38,709,35,23,NYJ,GB,20,35,-15
1,33,21,38,38,NYJ,GB,35,38,-3
1,30,2695,7,3,PHI,HOU,0,7,-7
1,47,1235,16,16,PHI,HOU,13,16,-3
1,35,3,32,30,PHI,HOU,29,30,-1
1,50,2266,10,7,CAR,ATL,7,7,0
1,39,2135,10,10,CAR,ATL,7,10,-3
1,40,1875,7,17,IND,NYG,14,7,7
1,27,564,21,27,IND,NYG,24,21,3
0,47,2171,7,7,MIA,JAX,7,7,0
0,56,1804,7,7,MIA,JAX,7,7,0
1,26,659,7,10,MIA,JAX,7,7,0
1,36,3131,3,0,ARI,LA,0,0,0
0,54,1817,9,21,ARI,LA,9,21,-12
0,57,1804,9,21,ARI,LA,21,9,12
1,21,1241,9,24,ARI,LA,21,9,12
0,37,3053,0,0,SF,CHI,0,0,0
1,33,2458,3,0,SF,CHI,0,0,0
1,30,2152,6,0,SF,CHI,3,0,3
1,23,1805,9,7,SF,CHI,6,7,-1
1,49,3037,0,3,NO,PIT,0,0,0
1,30,2650,7,6,NO,PIT,3,7,-4
1,43,1807,17,14,NO,PIT,14,14,0
0,50,377,24,28,NO,PIT,24,28,-4
1,54,3098,7,3,SEA,KC,0,7,-7
0,36,2812,7,3,SEA,KC,7,3,4
1,28,1470,17,10,SEA,KC,14,10,4
1,29,632,24,20,SEA,KC,17,24,-7
1,32,83,38,31,SEA,KC,28,38,-10
1,43,1823,16,0,OAK,DEN,13,0,13
0,58,1804,16,0,OAK,DEN,0,16,-16
1,45,282,26,14,OAK,DEN,23,14,9
0,42,2581,14,0,BUF,MIA,14,0,14
1,29,991,28,16,BUF,MIA,13,28,-15
1,36,2309,10,0,TB,ATL,7,0,7
1,45,1303,20,14,TB,ATL,17,14,3
1,49,1024,20,17,TB,ATL,14,20,-6
1,37,4,32,34,TB,ATL,31,32,-1
0,34,2771,0,0,NYG,DAL,0,0,0
1,48,1445,10,14,NYG,DAL,7,14,-7
1,38,159,35,28,NYG,DAL,32,28,4
1,22,1803,0,23,NO,CAR,20,0,20
1,51,502,7,33,NO,CAR,30,7,23
1,40,2758,7,3,NE,NYJ,0,7,-7
1,38,584,30,3,NE,NYJ,27,3,24
1,25,3311,0,3,HOU,JAX,0,0,0
1,23,3023,3,3,HOU,JAX,0,3,-3
1,24,655,20,3,HOU,JAX,17,3,14
1,43,1092,0,24,GB,DET,21,0,21
1,33,2726,0,3,WAS,PHI,0,0,0
1,28,1815,3,6,DEN,LAC,0,6,-6
1,50,1869,21,3,KC,OAK,0,21,-21
1,45,1858,3,13,MIN,CHI,0,13,-13
1,42,269,10,24,MIN,CHI,21,10,11
1,38,3271,3,0,BAL,CLE,0,0,0
1,35,2175,20,7,BAL,CLE,17,7,10
0,46,1804,20,7,BAL,CLE,7,20,-13
1,44,1328,23,14,BAL,CLE,20,14,6
1,35,828,23,17,BAL,CLE,14,23,-9
1,23,443,26,17,BAL,CLE,23,17,6
1,30,2836,14,3,LA,SF,0,14,-14
1,28,1803,31,10,LA,SF,28,10,18
1,51,709,48,17,LA,SF,45,17,28
1,49,1937,0,9,PIT,CIN,6,0,6
1,39,1804,3,9,PIT,CIN,0,9,-9
1,47,520,13,9,PIT,CIN,10,9,1
1,32,380,13,12,PIT,CIN,9,13,-4
1,35,120,16,12,PIT,CIN,13,12,1
1,36,3145,0,3,SEA,ARI,0,0,0
1,50,1878,14,13,SEA,ARI,10,14,-4
1,42,385,24,21,SEA,ARI,21,21,0
1,55,114,24,24,SEA,ARI,21,24,-3
1,33,3,27,24,SEA,ARI,24,24,0
1,53,1844,6,17,TEN,IND,14,6,8
1,38,1805,9,17,TEN,IND,6,17,-11
1,25,240,16,27,TEN,IND,24,16,8
1,38,2954,3,0,CHI,GB,0,0,0
1,39,320,3,10,CHI,GB,7,3,4
0,53,2747,0,0,CAR,LA,0,0,0
1,49,2628,0,3,CAR,LA,0,0,0
1,56,1867,0,13,CAR,LA,10,0,10
1,46,1802,3,13,CAR,LA,0,13,-13
1,27,1616,3,16,CAR,LA,13,3,10
1,52,916,13,23,CAR,LA,10,23,-13
0,41,250,20,30,CAR,LA,30,20,10
1,41,2871,0,10,PHI,WAS,7,0,7
1,48,1804,7,20,PHI,WAS,17,7,10
1,22,192,32,20,PHI,WAS,29,20,9
0,45,1830,6,0,NYJ,BUF,6,0,6
1,43,1132,16,3,NYJ,BUF,0,16,-16
1,54,2443,3,28,MIA,BAL,0,28,-28
1,34,927,10,52,MIA,BAL,49,10,39
1,28,3240,0,10,JAX,KC,7,0,7
1,37,2499,10,17,JAX,KC,7,17,-10
1,25,2279,10,20,JAX,KC,17,10,7
1,23,2065,13,20,JAX,KC,10,20,-10
1,46,1828,13,23,JAX,KC,20,13,7
1,35,218,19,40,JAX,KC,37,19,18
1,37,3096,6,3,CLE,TEN,0,6,-6
1,53,1618,6,15,CLE,TEN,12,6,6
1,40,1866,17,6,LAC,IND,14,6,8
0,46,1803,17,6,LAC,IND,6,17,-11
1,44,1579,17,9,LAC,IND,6,17,-11
0,29,812,24,16,LAC,IND,16,24,-8
1,39,2872,0,3,SEA,CIN,0,0,0
0,45,1363,14,17,SEA,CIN,17,14,3
1,27,423,21,20,SEA,CIN,17,21,-4
1,29,3372,0,3,TB,SF,0,0,0
1,36,1979,7,6,TB,SF,3,7,-4
0,57,1062,14,20,TB,SF,20,14,6
1,31,291,17,20,TB,SF,14,20,-6
1,47,141,17,23,TB,SF,20,17,3
1,28,1563,21,10,DAL,NYG,7,21,-14
1,55,2652,0,3,ARI,DET,0,0,0
1,20,1882,3,17,ARI,DET,0,17,-17
1,42,1183,6,17,ARI,DET,3,17,-14
1,34,673,9,24,ARI,DET,6,24,-18
1,28,441,27,24,ARI,DET,24,24,0
1,33,232,27,27,ARI,DET,24,27,-3
1,25,2514,10,0,NE,PIT,7,0,7
1,41,1821,20,0,NE,PIT,17,0,17
1,19,1519,20,3,NE,PIT,0,20,-20
1,35,916,30,3,NE,PIT,27,3,24
1,39,401,33,3,NE,PIT,30,3,27
1,32,2367,3,7,NO,HOU,0,7,-7
0,56,1804,3,14,NO,HOU,3,14,-11
1,47,55,27,21,NO,HOU,24,21,3
1,58,2,30,28,NO,HOU,27,28,-1
0,64,1805,14,0,OAK,DEN,0,14,-14
1,26,1462,14,3,OAK,DEN,0,14,-14
1,26,1125,14,6,OAK,DEN,3,14,-11
1,39,523,21,9,OAK,DEN,6,21,-15
1,29,281,24,9,OAK,DEN,21,9,12
1,40,3040,0,3,CAR,TB,0,0,0
1,32,2876,3,3,CAR,TB,0,3,-3
1,37,2310,6,3,CAR,TB,3,3,0
1,54,1803,9,10,CAR,TB,6,10,-4
1,51,1378,12,10,CAR,TB,9,10,-1
0,42,902,12,17,CAR,TB,17,12,5
1,32,150,14,20,CAR,TB,17,14,3
1,22,2841,7,3,BAL,ARI,0,7,-7
1,33,2651,10,3,BAL,ARI,7,3,4
1,21,2314,10,6,BAL,ARI,3,10,-7
1,21,1442,17,9,BAL,ARI,6,17,-11
1,28,900,20,9,BAL,ARI,17,9,8
1,51,542,23,17,BAL,ARI,20,17,3
1,25,831,14,24,WAS,DAL,21,14,7
1,49,1180,17,13,TEN,IND,14,13,1
0,45,635,17,13,TEN,IND,17,13,4
1,41,1952,10,7,PIT,SEA,7,7,0
0,58,1803,10,7,PIT,SEA,7,10,-3
1,33,1285,13,14,PIT,SEA,10,14,-4
0,48,1914,7,21,NYG,BUF,7,21,-14
0,52,2573,7,14,CIN,SF,7,14,-7
1,37,2222,10,21,CIN,SF,7,21,-14
1,33,1806,10,24,CIN,SF,21,10,11
1,38,1179,10,34,CIN,SF,31,10,21
0,39,428,10,41,CIN,SF,41,10,31
0,40,2162,6,7,DET,LAC,6,7,-1
1,39,1804,6,10,DET,LAC,7,6,1
0,39,1033,6,10,DET,LAC,10,6,4
0,41,710,6,10,DET,LAC,10,6,4
0,47,3261,7,0,GB,MIN,0,7,-7
1,31,1855,21,10,GB,MIN,7,21,-14
1,39,2818,3,0,HOU,JAX,0,0,0
1,40,2001,3,3,HOU,JAX,0,3,-3
1,22,1802,6,3,HOU,JAX,3,3,0
1,32,365,13,6,HOU,JAX,3,13,-10
0,48,2312,0,7,MIA,NE,7,0,7
1,28,1429,0,16,MIA,NE,13,0,13
1,29,3324,3,0,OAK,KC,0,0,0
1,24,3226,3,0,LA,NO,0,0,0
1,34,2470,3,3,LA,NO,0,3,-3
1,22,1807,6,3,LA,NO,3,3,0
1,52,1499,6,6,LA,NO,3,6,-3
1,42,662,20,9,LA,NO,6,20,-14
1,43,3290,3,0,DEN,CHI,0,0,0
1,40,2619,3,3,DEN,CHI,0,3,-3
1,52,2115,3,6,DEN,CHI,3,3,0
1,32,820,6,13,DEN,CHI,3,13,-10
1,53,1,14,16,DEN,CHI,13,14,-1
1,50,3273,3,0,ATL,PHI,0,0,0
1,34,2450,3,3,ATL,PHI,0,3,-3
0,50,2267,3,3,ATL,PHI,3,3,0
1,41,1803,10,6,ATL,PHI,3,10,-7
1,23,3330,0,3,NYJ,CLE,0,0,0
1,48,3079,0,6,NYJ,CLE,3,0,3
1,46,1980,3,13,NYJ,CLE,0,13,-13
1,43,1805,3,16,NYJ,CLE,13,3,10
1,40,1379,17,0,JAX,TEN,14,0,14
1,48,458,20,7,JAX,TEN,17,7,10
1,34,2433,11,0,BUF,CIN,8,0,8
1,45,1936,14,0,BUF,CIN,11,0,11
0,62,1807,14,0,BUF,CIN,14,0,14
1,43,298,14,17,BUF,CIN,14,14,0
1,25,3390,3,0,PHI,DET,0,0,0
1,25,2012,10,17,PHI,DET,14,10,4
1,33,1859,10,20,PHI,DET,17,10,7
0,46,113,24,27,PHI,DET,27,24,3
1,37,1432,23,0,NE,NYJ,20,0,20
1,50,900,31,7,MIN,OAK,28,7,21
0,51,515,31,7,MIN,OAK,7,31,-24
1,24,229,34,7,MIN,OAK,31,7,24
1,42,1810,23,6,KC,BAL,20,6,14
1,39,403,30,22,KC,BAL,19,30,-11
1,36,279,33,22,KC,BAL,30,22,8
1,49,3276,3,0,IND,ATL,0,0,0
1,21,2154,13,0,IND,ATL,10,0,10
1,34,1944,13,3,IND,ATL,0,13,-13
1,42,2483,10,7,GB,DEN,7,7,0
1,30,2033,10,10,GB,DEN,7,10,-3
1,41,353,27,16,GB,DEN,24,16,8
0,45,69,27,16,GB,DEN,27,16,11
0,47,3505,0,0,DAL,MIA,0,0,0
1,28,3331,3,0,DAL,MIA,0,0,0
1,22,2758,10,3,DAL,MIA,0,10,-10
1,33,2151,10,6,DAL,MIA,3,10,-7
0,55,479,24,6,DAL,MIA,24,6,18
1,36,2951,6,3,TB,NYG,0,6,-6
1,47,2260,15,10,TB,NYG,12,10,2
1,27,2048,18,10,TB,NYG,15,10,5
1,52,1804,28,10,TB,NYG,25,10,15
1,23,364,31,25,TB,NYG,28,25,3
0,34,4,31,32,TB,NYG,31,32,-1
1,34,1900,10,7,ARI,CAR,7,7,0
1,47,1072,20,21,ARI,CAR,17,21,-4
1,36,271,20,38,ARI,CAR,35,20,15
1,46,3412,0,3,SF,PIT,0,0,0
1,26,2827,0,6,SF,PIT,3,0,3
1,24,2208,3,6,SF,PIT,0,6,-6
1,34,2436,10,0,LAC,HOU,7,0,7
0,56,1802,17,7,LAC,HOU,7,17,-10
1,43,439,20,27,LAC,HOU,17,27,-10
1,53,2950,0,3,CLE,LA,0,0,0
1,23,2504,3,3,CLE,LA,0,3,-3
0,48,2053,3,3,CLE,LA,3,3,0
1,35,1804,6,3,CLE,LA,3,3,0
1,37,400,13,20,CLE,LA,17,13,4
0,43,2606,0,7,WAS,CHI,0,7,-7
1,35,1805,3,28,WAS,CHI,0,28,-28
0,44,1520,3,28,WAS,CHI,28,3,25
1,38,114,15,31,WAS,CHI,28,15,13
1,30,2644,10,0,GB,PHI,7,0,7
1,31,2308,13,7,GB,PHI,10,7,3
1,45,2407,7,17,ATL,TEN,14,7,7
0,32,1835,7,24,ATL,TEN,7,24,-17
1,42,1601,10,24,ATL,TEN,7,24,-17
1,21,1937,14,3,NYG,WAS,0,14,-14
1,30,1803,17,3,NYG,WAS,14,3,11
1,44,3317,0,3,MIA,LAC,0,0,0
1,30,2475,10,10,MIA,LAC,7,10,-3
0,50,2019,10,10,MIA,LAC,10,10,0
0,52,1803,10,17,MIA,LAC,10,17,-7
1,45,987,10,20,MIA,LAC,17,10,7
1,51,452,10,30,MIA,LAC,27,10,17
1,26,2257,10,21,IND,OAK,7,21,-14
0,57,1837,10,21,IND,OAK,10,21,-11
1,26,1098,10,24,IND,OAK,21,10,11
1,48,2848,0,3,HOU,CAR,0,0,0
0,52,2620,0,3,HOU,CAR,0,3,-3
1,37,2283,3,3,HOU,CAR,0,3,-3
1,55,895,10,13,HOU,CAR,10,10,0
1,26,31,10,16,HOU,CAR,13,10,3
1,25,3309,3,0,DET,KC,0,0,0
0,36,3043,3,0,DET,KC,0,3,-3
1,23,2656,10,3,DET,KC,0,10,-10
1,48,1868,13,10,DET,KC,10,10,0
1,44,1806,13,13,DET,KC,10,13,-3
1,53,1284,16,20,DET,KC,13,20,-7
1,24,1811,7,10,BAL,CLE,7,7,0
1,41,1579,10,10,BAL,CLE,7,10,-3
1,43,421,18,33,BAL,CLE,30,18,12
1,46,1920,3,13,BUF,NE,0,13,-13
0,49,1804,3,13,BUF,NE,3,13,-10
1,23,960,10,16,BUF,NE,13,10,3
1,58,1807,17,28,LA,TB,14,28,-14
1,44,1448,20,28,LA,TB,17,28,-11
1,58,1178,20,31,LA,TB,28,20,8
1,21,157,40,48,LA,TB,45,40,5
0,43,3288,0,0,ARI,SEA,0,0,0
1,33,3003,0,3,ARI,SEA,0,0,0
1,33,2634,3,10,ARI,SEA,0,10,-10
0,48,2263,3,17,ARI,SEA,3,17,-14
1,24,1820,3,20,ARI,SEA,17,3,14
1,25,1804,10,0,CHI,MIN,7,0,7
1,38,1672,13,0,CHI,MIN,10,0,10
1,30,1087,16,0,CHI,MIN,13,0,13
1,25,2896,7,3,DEN,JAX,0,7,-7
1,33,2060,17,3,DEN,JAX,14,3,11
1,40,1811,17,6,DEN,JAX,3,17,-14
1,34,178,17,23,DEN,JAX,20,17,3
1,33,4,24,26,DEN,JAX,23,24,-1
1,28,3013,0,3,NO,DAL,0,0,0
1,40,2700,3,3,NO,DAL,0,3,-3
1,42,2326,6,3,NO,DAL,3,3,0
1,19,1802,9,3,NO,DAL,6,3,3
1,26,825,12,10,NO,DAL,9,10,-1
1,28,3205,0,3,PIT,CIN,0,0,0
1,29,1861,10,3,PIT,CIN,7,3,4
1,49,356,27,3,PIT,CIN,24,3,21
1,47,3449,0,3,SEA,LA,0,0,0
1,32,2999,0,6,SEA,LA,3,0,3
0,48,1898,14,6,SEA,LA,14,6,8
1,42,821,24,26,SEA,LA,21,26,-5
1,36,563,24,29,SEA,LA,26,24,2
0,44,15,30,29,SEA,LA,29,30,-1
0,56,1985,21,14,CAR,JAX,21,14,7
1,35,1861,21,17,CAR,JAX,14,21,-7
0,46,1315,28,24,CAR,JAX,28,24,4
1,38,357,28,27,CAR,JAX,24,28,-4
1,37,2439,7,9,WAS,NE,6,7,-1
1,23,1834,7,12,WAS,NE,9,7,2
0,50,2700,0,0,TEN,BUF,0,0,0
0,36,1849,0,7,TEN,BUF,0,7,-7
0,33,747,7,7,TEN,BUF,7,7,0
0,53,395,7,14,TEN,BUF,7,14,-7
1,27,3144,0,3,PIT,BAL,0,0,0
1,41,2083,10,17,PIT,BAL,7,17,-10
1,29,1803,13,17,PIT,BAL,10,17,-7
1,26,702,20,20,PIT,BAL,17,20,-3
1,33,161,23,20,PIT,BAL,20,20,0
1,48,14,23,23,PIT,BAL,20,23,-3
1,46,331,23,26,PIT,BAL,23,23,0
1,23,3211,3,0,CIN,ARI,0,0,0
0,37,2580,3,7,CIN,ARI,7,3,4
1,23,2113,3,10,CIN,ARI,7,3,4
1,48,2012,6,10,CIN,ARI,3,10,-7
1,20,1801,6,13,CIN,ARI,10,6,4
1,23,1418,9,13,CIN,ARI,6,13,-7
1,22,808,9,16,CIN,ARI,13,9,4
1,31,2,23,26,CIN,ARI,23,23,0
1,35,2696,7,10,HOU,ATL,7,7,0
1,50,2047,16,10,HOU,ATL,13,10,3
1,26,1360,26,17,HOU,ATL,23,17,6
1,29,2942,3,0,NO,TB,0,0,0
1,42,2137,10,10,NO,TB,7,10,-3
1,31,3230,0,3,NYG,MIN,0,0,0
1,48,2276,7,13,NYG,MIN,10,7,3
1,32,1850,7,18,NYG,MIN,15,7,8
1,32,1359,10,18,NYG,MIN,7,18,-11
1,45,253,10,28,NYG,MIN,25,10,15
1,41,1920,17,0,OAK,CHI,14,0,14
0,55,2575,14,0,PHI,NYJ,0,14,-14
1,28,988,24,0,PHI,NYJ,21,0,21
0,48,2329,0,14,LAC,DEN,0,14,-14
1,40,2122,0,17,LAC,DEN,14,0,14
0,54,540,7,17,LAC,DEN,17,7,10
1,45,412,10,17,LAC,DEN,7,17,-10
1,46,120,10,20,LAC,DEN,17,10,7
1,32,15,13,20,LAC,DEN,10,20,-10
1,20,1943,0,17,DAL,GB,14,0,14
0,54,1845,0,17,DAL,GB,0,17,-17
1,36,1258,3,24,DAL,GB,0,24,-24
1,38,491,17,34,DAL,GB,31,17,14
0,33,104,24,34,DAL,GB,24,34,-10
1,29,3245,3,0,KC,IND,0,0,0
1,32,2476,10,10,KC,IND,7,10,-3
1,32,1813,10,13,KC,IND,10,10,0
1,31,464,10,16,KC,IND,13,10,3
1,29,150,10,19,KC,IND,16,10,6
1,36,79,13,19,KC,IND,10,19,-9
0,47,2774,14,0,SF,CLE,14,0,14
1,30,2486,14,3,SF,CLE,0,14,-14
0,52,1815,21,3,SF,CLE,21,3,18
0,32,1004,28,3,SF,CLE,28,3,25
1,44,313,31,3,SF,CLE,28,3,25
0,40,1072,21,14,NE,NYG,21,14,7
1,49,3505,0,3,TB,CAR,0,0,0
0,60,1801,7,17,TB,CAR,17,7,10
1,46,1405,7,20,TB,CAR,17,7,10
1,54,1232,10,27,TB,CAR,7,27,-20
1,29,479,18,37,TB,CAR,34,18,16
0,41,76,26,37,TB,CAR,37,26,11
1,39,1873,3,7,MIA,WAS,0,7,-7
1,21,1159,3,17,MIA,WAS,14,3,11
0,55,900,3,17,MIA,WAS,17,3,14
1,39,2817,10,0,MIN,PHI,7,0,7
1,53,2535,10,3,MIN,PHI,0,10,-10
1,40,1283,24,20,MIN,PHI,17,24,-7
1,41,3324,10,0,KC,HOU,7,0,7
1,44,3050,10,3,KC,HOU,0,10,-10
0,50,1904,17,16,KC,HOU,17,16,1
0,46,1560,17,23,KC,HOU,23,17,6
1,47,2853,0,3,JAX,NO,0,0,0
1,22,1964,3,3,JAX,NO,0,3,-3
1,21,1422,3,6,JAX,NO,3,3,0
1,32,1094,6,6,JAX,NO,3,6,-3
1,38,2449,20,9,CLE,SEA,6,20,-14
1,20,2248,20,12,CLE,SEA,9,20,-11
1,40,2692,17,7,BAL,CIN,14,7,7
1,22,1839,17,10,BAL,CIN,7,17,-10
1,49,907,20,10,BAL,CIN,17,10,7
1,21,229,23,10,BAL,CIN,20,10,10
0,55,1803,7,7,LA,SF,7,7,0
1,25,1202,7,17,LA,SF,14,7,7
1,34,728,7,20,LA,SF,17,7,10
1,39,3045,3,7,ARI,ATL,0,7,-7
1,29,2021,17,10,ARI,ATL,7,17,-10
1,22,1807,20,10,ARI,ATL,17,10,7
1,44,1371,27,13,ARI,ATL,10,27,-17
1,50,2700,7,3,NYJ,DAL,0,7,-7
1,62,1805,21,6,NYJ,DAL,3,21,-18
1,32,1374,21,9,NYJ,DAL,6,21,-15
0,40,853,21,9,NYJ,DAL,9,21,-12
1,38,207,24,16,NYJ,DAL,21,16,5
1,31,3319,3,0,DEN,TEN,0,0,0
1,53,2082,6,0,DEN,TEN,3,0,3
1,48,297,16,0,DEN,TEN,13,0,13
0,43,1837,0,21,LAC,PIT,0,21,-21
1,20,1395,0,24,LAC,PIT,21,0,21
1,38,844,3,24,LAC,PIT,0,24,-24
1,26,3464,0,3,GB,DET,0,0,0
1,22,2612,0,13,GB,DET,10,0,10
1,37,1811,10,13,GB,DET,7,13,-6
1,48,1659,13,13,GB,DET,10,13,-3
1,41,1444,13,16,GB,DET,13,13,0
1,51,1111,13,19,GB,DET,16,13,3
1,54,742,13,22,GB,DET,19,13,6
1,23,2,23,22,GB,DET,20,22,-2
1,33,2764,6,10,DEN,KC,7,6,1
1,20,2284,6,13,DEN,KC,10,6,4
0,45,1989,6,20,DEN,KC,6,20,-14
1,39,308,6,30,DEN,KC,27,6,21
1,39,3358,3,0,BUF,MIA,0,0,0
1,43,2932,6,0,BUF,MIA,3,0,3
1,45,2411,9,7,BUF,MIA,6,7,-1
1,21,2194,0,3,CIN,JAX,0,0,0
1,29,1807,7,6,CIN,JAX,3,7,-4
1,37,1316,7,9,CIN,JAX,6,7,-1
1,38,936,10,9,CIN,JAX,7,9,-2
1,26,120,10,27,CIN,JAX,24,10,14
1,46,1106,24,28,DET,MIN,21,28,-7
0,45,776,24,28,DET,MIN,28,24,4
1,45,3445,0,3,GB,OAK,0,0,0
1,52,3388,3,0,ATL,LA,0,0,0
0,40,3011,3,0,ATL,LA,0,3,-3
1,55,2807,3,3,ATL,LA,0,3,-3
1,25,1920,3,13,ATL,LA,10,3,7
0,50,1875,3,13,ATL,LA,3,13,-10
1,20,346,3,30,ATL,LA,27,3,24
1,47,2345,7,3,IND,HOU,0,7,-7
1,31,2190,7,6,IND,HOU,3,7,-4
1,26,1827,14,9,IND,HOU,6,14,-8
0,39,3110,0,0,WAS,SF,0,0,0
0,45,2460,0,0,WAS,SF,0,0,0
1,28,1232,0,3,WAS,SF,0,0,0
1,22,546,0,6,WAS,SF,3,0,3
1,29,27,0,9,WAS,SF,6,0,6
1,47,2614,0,17,NYG,ARI,14,0,14
0,37,971,14,24,NYG,ARI,14,24,-10
1,35,133,21,27,NYG,ARI,24,21,3
1,45,3066,3,0,TEN,LAC,0,0,0
1,29,2707,3,3,TEN,LAC,0,3,-3
1,50,659,16,13,TEN,LAC,10,16,-6
1,46,2498,10,9,CHI,NO,7,9,-2
1,39,2195,10,12,CHI,NO,9,10,-1
0,42,1942,10,12,CHI,NO,12,10,2
0,52,1522,10,19,CHI,NO,19,10,9
1,30,769,10,29,CHI,NO,26,10,16
1,25,3322,0,3,SEA,BAL,0,0,0
1,28,2470,7,6,SEA,BAL,3,7,-4
1,34,2259,10,6,SEA,BAL,7,6,1
1,31,1806,13,13,SEA,BAL,10,13,-3
0,53,1311,13,13,SEA,BAL,13,13,0
1,22,230,13,23,SEA,BAL,20,13,7
1,35,113,16,30,SEA,BAL,13,30,-17
1,26,1894,24,7,DAL,PHI,21,7,14
1,63,1804,27,7,DAL,PHI,24,7,17
1,38,1202,27,10,DAL,PHI,7,27,-20
1,29,760,30,10,DAL,PHI,27,10,17
1,34,2933,0,10,NYJ,NE,7,0,7
1,50,3025,3,0,MIN,WAS,0,0,0
1,21,2643,3,3,MIN,WAS,0,3,-3
1,29,2249,6,3,MIN,WAS,3,3,0
1,30,1920,6,6,MIN,WAS,3,6,-3
1,27,1417,16,6,MIN,WAS,13,6,7
1,43,1215,16,9,MIN,WAS,6,16,-10
1,40,640,19,9,MIN,WAS,16,9,7
1,42,3382,0,3,ATL,SEA,0,0,0
0,51,2700,0,3,ATL,SEA,0,3,-3
0,53,1953,0,17,ATL,SEA,0,17,-17
1,47,1110,11,24,ATL,SEA,8,24,-16
1,54,358,11,27,ATL,SEA,24,11,13
1,37,81,20,27,ATL,SEA,17,27,-10
0,45,3387,0,0,IND,DEN,0,0,0
1,21,2580,0,3,IND,DEN,0,0,0
1,29,2137,0,6,IND,DEN,3,0,3
1,55,1806,3,6,IND,DEN,0,6,-6
1,45,1269,6,13,IND,DEN,3,13,-10
1,51,26,15,13,IND,DEN,12,13,-1
1,22,3393,0,3,TEN,TB,0,0,0
1,48,2276,14,6,TEN,TB,3,14,-11
1,24,2030,14,9,TEN,TB,6,14,-8
1,51,1875,17,9,TEN,TB,14,9,5
1,42,942,20,23,TEN,TB,17,23,-6
0,47,3240,0,0,NO,ARI,0,0,0
1,31,3046,0,3,NO,ARI,0,0,0
1,26,2657,3,3,NO,ARI,0,3,-3
1,31,2123,10,6,NO,ARI,3,10,-7
1,50,1007,17,9,NO,ARI,6,17,-11
1,23,3104,3,0,LA,CIN,0,0,0
1,28,2700,3,3,LA,CIN,0,3,-3
1,37,2922,0,3,BUF,PHI,0,0,0
0,53,1802,7,11,BUF,PHI,7,11,-4
0,33,2838,0,0,CHI,LAC,0,0,0
1,22,2688,3,0,CHI,LAC,0,0,0
1,25,2060,6,0,CHI,LAC,3,0,3
1,19,1801,9,7,CHI,LAC,6,7,-1
1,20,942,16,10,CHI,LAC,7,16,-9
0,42,657,16,10,CHI,LAC,10,16,-6
0,41,4,16,17,CHI,LAC,16,17,-1
0,53,2294,14,7,DET,NYG,14,7,7
1,52,1825,17,13,DET,NYG,14,13,1
1,29,1980,16,7,JAX,NYJ,13,7,6
1,43,1816,19,7,JAX,NYJ,16,7,9
1,24,1035,22,7,JAX,NYJ,19,7,12
1,41,2968,7,3,SF,CAR,0,7,-7
1,20,776,44,13,SF,CAR,41,13,28
1,33,1867,10,14,HOU,OAK,7,14,-7
1,40,1533,13,14,HOU,OAK,10,14,-4
1,44,652,20,24,HOU,OAK,21,20,1
1,20,3098,3,0,NE,CLE,0,0,0
0,29,1945,17,7,NE,CLE,17,7,10
1,38,1421,17,10,NE,CLE,7,17,-10
1,29,466,27,10,NE,CLE,24,10,14
0,34,252,27,10,NE,CLE,27,10,17
1,47,158,27,13,NE,CLE,10,27,-17
0,50,2956,0,7,KC,GB,0,7,-7
1,28,1860,17,14,KC,GB,14,14,0
1,35,995,17,17,KC,GB,14,17,-3
1,42,1969,3,14,PIT,MIA,0,14,-14
0,54,1588,10,14,PIT,MIA,10,14,-4
1,41,337,27,14,PIT,MIA,24,14,10
1,36,568,17,28,ARI,SF,14,28,-14
1,52,3204,0,3,JAX,HOU,0,0,0
1,30,1912,3,9,JAX,HOU,0,9,-9
0,58,1811,3,9,JAX,HOU,9,3,6
1,42,1202,3,12,JAX,HOU,9,3,6
1,28,3108,3,0,PHI,CHI,0,0,0
1,28,2605,6,0,PHI,CHI,3,0,3
1,38,29,22,14,PHI,CHI,19,14,5
1,25,3132,0,3,PIT,IND,0,0,0
1,21,2761,3,3,PIT,IND,0,3,-3
1,51,1800,13,16,PIT,IND,10,16,-6
1,33,900,23,18,PIT,IND,20,18,2
1,26,399,26,24,PIT,IND,23,24,-1
0,43,74,26,24,PIT,IND,24,26,-2
0,49,2830,0,7,MIA,NYJ,7,0,7
1,52,1806,21,12,MIA,NYJ,9,21,-12
0,49,1608,21,12,MIA,NYJ,21,12,9
1,40,1312,21,15,MIA,NYJ,12,21,-9
1,26,965,24,15,MIA,NYJ,21,15,6
1,29,19,26,18,MIA,NYJ,15,26,-11
1,24,2078,10,7,KC,MIN,7,7,0
1,29,1809,10,10,KC,MIN,7,10,-3
1,45,935,20,16,KC,MIN,17,16,1
1,54,156,23,23,KC,MIN,20,23,-3
1,44,3,26,23,KC,MIN,23,23,0
0,43,3287,0,0,CAR,TEN,0,0,0
1,35,2614,3,0,CAR,TEN,0,0,0
0,56,1804,17,0,CAR,TEN,0,17,-17
0,49,366,30,14,CAR,TEN,30,14,16
0,44,52,30,20,CAR,TEN,20,30,-10
1,42,2728,10,0,BUF,WAS,7,0,7
1,29,2445,10,3,BUF,WAS,0,10,-10
1,33,1836,17,6,BUF,WAS,3,17,-14
1,39,985,17,9,BUF,WAS,6,17,-11
0,47,2468,7,14,SEA,TB,7,14,-7
0,50,1802,13,21,SEA,TB,21,13,8
1,41,1102,21,24,SEA,TB,21,21,0
1,37,870,24,24,SEA,TB,21,24,-3
1,22,502,27,24,SEA,TB,24,24,0
1,45,327,27,27,SEA,TB,24,27,-3
0,40,3,34,34,SEA,TB,34,34,0
1,32,2614,10,7,OAK,DET,7,7,0
0,45,1555,17,14,OAK,DET,17,14,3
1,23,1187,17,17,OAK,DET,14,17,-3
1,29,3120,3,0,LAC,GB,0,0,0
1,40,2769,6,0,LAC,GB,3,0,3
1,34,1805,9,0,LAC,GB,6,0,6
1,43,1486,12,0,LAC,GB,9,0,9
1,54,950,19,3,LAC,GB,0,19,-19
0,44,135,26,11,LAC,GB,26,11,15
1,39,2572,7,3,DEN,CLE,0,7,-7
1,30,2237,14,6,DEN,CLE,3,14,-11
1,27,2033,14,9,DEN,CLE,6,14,-8
1,43,1912,17,9,DEN,CLE,14,9,5
1,30,1819,17,12,DEN,CLE,9,17,-8
1,39,2853,10,0,BAL,NE,7,0,7
1,22,2024,17,10,BAL,NE,7,17,-10
1,19,1810,17,13,BAL,NE,10,17,-7
1,21,3505,3,0,NYG,DAL,0,0,0
1,35,3203,3,3,NYG,DAL,0,3,-3
0,54,2834,3,3,NYG,DAL,3,3,0
1,25,1973,12,3,NYG,DAL,9,3,6
1,52,1803,12,13,NYG,DAL,10,12,-2
1,28,1186,12,16,NYG,DAL,13,12,1
1,26,930,15,16,NYG,DAL,12,16,-4
1,29,713,18,23,NYG,DAL,15,23,-8
1,40,3185,3,0,OAK,LAC,0,0,0
1,22,1596,20,14,OAK,LAC,17,14,3
0,53,1381,20,14,OAK,LAC,20,14,6
1,27,928,20,17,OAK,LAC,14,20,-6
1,42,2619,3,14,CIN,BAL,0,14,-14
1,39,154,13,49,CIN,BAL,10,49,-39
1,27,2018,9,7,CLE,BUF,6,7,-1
0,34,1820,9,7,CLE,BUF,7,9,-2
1,47,1133,12,9,CLE,BUF,9,9,0
0,53,22,19,16,CLE,BUF,16,19,-3
1,22,3225,0,3,CHI,DET,0,0,0
1,54,2086,0,6,CHI,DET,3,0,3
0,54,1889,14,13,NYJ,NYG,14,13,1
1,53,1006,24,27,NYJ,NYG,21,27,-6
1,35,459,34,27,NYJ,NYG,31,27,4
1,30,2987,0,10,TEN,KC,7,0,7
1,41,1877,13,13,TEN,KC,10,13,-3
1,43,1023,20,22,TEN,KC,19,20,-1
1,39,199,27,32,TEN,KC,29,27,2
0,52,3,35,32,TEN,KC,32,35,-3
1,37,3377,0,3,TB,ARI,0,0,0
1,54,2659,7,6,TB,ARI,3,7,-4
1,30,2337,10,6,TB,ARI,7,6,1
1,45,1422,20,13,TB,ARI,17,13,4
1,41,588,23,20,TB,ARI,20,20,0
1,37,3272,0,3,NO,ATL,0,0,0
1,29,2953,3,3,NO,ATL,0,3,-3
1,36,1895,3,13,NO,ATL,10,3,7
1,47,1805,6,13,NO,ATL,3,13,-10
1,28,1269,9,13,NO,ATL,6,13,-7
1,48,453,9,23,NO,ATL,20,9,11
1,30,155,9,26,NO,ATL,23,9,14
1,47,3109,0,3,IND,MIA,0,0,0
1,25,1374,3,10,IND,MIA,0,10,-10
1,39,943,6,10,IND,MIA,3,10,-7
1,48,350,12,13,IND,MIA,10,12,-2
1,48,216,12,16,IND,MIA,13,12,1
0,56,1803,14,7,PIT,LA,7,14,-7
1,30,914,14,10,PIT,LA,7,14,-7
1,33,169,17,12,PIT,LA,14,12,2
1,50,2700,7,10,GB,CAR,7,7,0
1,47,986,24,10,GB,CAR,21,10,11
0,57,3428,0,0,DAL,MIN,0,0,0
1,26,1802,14,17,DAL,MIN,14,14,0
1,27,1481,14,20,DAL,MIN,17,14,3
1,23,603,24,28,DAL,MIN,21,28,-7
1,43,3204,3,0,SF,SEA,0,0,0
1,39,381,21,21,SF,SEA,18,21,-3
1,46,109,21,24,SF,SEA,21,21,0
1,47,6,24,24,SF,SEA,21,24,-3
0,47,190,24,24,SF,SEA,24,24,0
1,42,4,24,27,SF,SEA,24,24,0
0,44,3172,7,0,CLE,PIT,0,7,-7
0,45,1956,14,0,CLE,PIT,14,0,14
0,50,901,14,7,CLE,PIT,14,7,7
1,38,3399,0,3,CAR,ATL,0,0,0
0,38,3099,0,3,CAR,ATL,3,0,3
1,23,2145,0,13,CAR,ATL,10,0,10
1,31,784,3,26,CAR,ATL,0,26,-26
1,29,425,3,29,CAR,ATL,26,3,23
1,30,2842,7,3,DET,DAL,0,7,-7
1,34,1205,21,27,DET,DAL,24,21,3
1,34,2310,10,7,IND,JAX,7,7,0
0,46,897,24,7,IND,JAX,7,24,-17
1,51,3429,0,3,MIA,BUF,0,0,0
1,34,2974,0,6,MIA,BUF,3,0,3
1,21,2266,0,16,MIA,BUF,13,0,13
0,43,3307,0,0,BAL,HOU,0,0,0
0,43,1811,14,0,BAL,HOU,0,14,-14
1,34,1316,24,0,BAL,HOU,21,0,21
1,46,995,27,0,BAL,HOU,24,0,24
1,47,3396,0,3,MIN,DEN,0,0,0
1,29,1870,0,20,MIN,DEN,17,0,17
1,41,1167,7,23,MIN,DEN,20,7,13
0,43,499,20,23,MIN,DEN,23,20,3
1,44,2349,3,13,WAS,NYJ,0,13,-13
0,29,2201,3,13,WAS,NYJ,3,13,-10
0,49,277,11,34,WAS,NYJ,34,11,23
1,44,3229,0,3,TB,NO,0,0,0
1,26,2754,0,6,TB,NO,3,0,3
1,55,1573,10,20,TB,NO,7,20,-13
1,26,3335,0,3,SF,ARI,0,0,0
1,43,1803,10,16,SF,ARI,7,16,-9
1,43,1078,17,19,SF,ARI,16,17,-1
0,53,1808,14,7,OAK,CIN,7,14,-7
1,40,1348,14,10,OAK,CIN,7,14,-7
1,20,555,17,10,OAK,CIN,14,10,4
1,42,3522,3,0,PHI,NE,0,0,0
1,35,2320,10,3,PHI,NE,0,10,-10
1,22,2004,10,6,PHI,NE,3,10,-7
1,39,1907,10,9,PHI,NE,6,10,-4
0,48,3419,0,0,LA,CHI,0,0,0
0,47,2762,0,0,LA,CHI,0,0,0
1,38,2498,3,0,LA,CHI,0,0,0
1,27,3274,3,0,LAC,KC,0,0,0
0,40,2981,3,0,LAC,KC,3,0,3
1,26,2103,6,7,LAC,KC,3,7,-4
1,41,1907,6,10,LAC,KC,7,6,1
1,49,1801,9,10,LAC,KC,6,10,-4
1,35,2626,3,0,HOU,IND,0,0,0
1,36,1802,10,10,HOU,IND,7,10,-3
1,36,1067,13,17,HOU,IND,10,17,-7
1,39,2775,3,0,BUF,DEN,0,0,0
1,23,2292,6,0,BUF,DEN,3,0,3
1,45,1365,13,3,BUF,DEN,0,13,-13
0,42,2150,0,7,CHI,NYG,7,0,7
0,43,1920,0,7,CHI,NYG,7,0,7
1,26,1811,3,7,CHI,NYG,0,7,-7
1,24,1332,13,7,CHI,NYG,10,7,3
1,26,2004,0,3,CIN,PIT,0,0,0
1,27,1211,10,10,CIN,PIT,7,10,-3
1,47,724,10,13,CIN,PIT,10,10,0
1,26,201,10,16,CIN,PIT,13,10,3
1,36,1801,28,3,CLE,MIA,0,28,-28
0,46,1148,28,10,CLE,MIA,28,10,18
1,40,685,31,17,CLE,MIA,28,17,11
1,26,414,34,17,CLE,MIA,31,17,14
1,25,3472,3,0,ATL,TB,0,0,0
1,40,1005,13,25,ATL,TB,10,25,-15
1,32,773,13,28,ATL,TB,25,13,12
1,38,496,16,28,ATL,TB,13,28,-15
1,41,2619,17,6,NO,CAR,14,6,8
1,41,2293,17,9,NO,CAR,6,17,-11
1,52,1421,24,18,NO,CAR,15,24,-9
0,28,120,31,31,NO,CAR,31,31,0
1,33,3,34,31,NO,CAR,31,31,0
1,28,3151,3,0,PHI,SEA,0,0,0
1,24,2236,3,10,PHI,SEA,7,3,4
0,39,3297,0,0,WAS,DET,0,0,0
1,28,2854,3,0,WAS,DET,0,0,0
1,24,2592,3,3,WAS,DET,0,3,-3
1,37,2148,13,3,WAS,DET,10,3,7
1,49,1819,13,6,WAS,DET,3,13,-10
1,21,723,13,16,WAS,DET,13,13,0
1,42,114,16,16,WAS,DET,13,16,-3
1,39,20,19,16,WAS,DET,16,16,0
1,48,3300,0,3,NYJ,OAK,0,0,0
1,24,3005,3,3,NYJ,OAK,0,3,-3
0,43,2237,10,3,NYJ,OAK,3,10,-7
1,35,1996,13,3,NYJ,OAK,10,3,7
0,48,1844,13,3,NYJ,OAK,13,3,10
1,49,1915,7,3,TEN,JAX,0,7,-7
1,50,293,42,20,TEN,JAX,17,42,-25
0,46,3164,0,0,NE,DAL,0,0,0
1,44,2571,10,0,NE,DAL,7,0,7
1,46,2320,10,3,NE,DAL,0,10,-10
0,46,2211,10,3,NE,DAL,10,3,7
1,27,1951,10,6,NE,DAL,3,10,-7
0,48,1804,10,6,NE,DAL,10,6,4
1,42,577,13,6,NE,DAL,10,6,4
1,29,368,13,9,NE,DAL,6,13,-7
1,29,2897,10,0,SF,GB,7,0,7
1,27,1979,13,0,SF,GB,10,0,10
1,48,1804,23,0,SF,GB,20,0,20
1,32,2390,3,14,LA,BAL,0,14,-14
1,46,1920,6,21,LA,BAL,3,21,-18
1,34,401,6,45,LA,BAL,42,6,36
1,25,1993,17,7,DET,CHI,14,7,7
1,30,1825,17,10,DET,CHI,7,17,-10
1,24,651,20,17,DET,CHI,17,17,0
0,50,2070,7,7,DAL,BUF,7,7,0
0,35,1804,7,13,DAL,BUF,7,13,-6
1,41,1552,7,16,DAL,BUF,13,7,6
0,47,1362,7,16,DAL,BUF,7,16,-9
1,26,504,7,26,DAL,BUF,23,7,16
1,22,2349,6,10,ATL,NO,7,6,1
0,42,2041,6,10,ATL,NO,6,10,-4
1,45,1808,9,17,ATL,NO,6,17,-11
1,47,1259,9,20,ATL,NO,17,9,8
1,42,619,9,23,ATL,NO,20,9,11
1,45,392,9,26,ATL,NO,23,9,14
1,43,120,18,26,ATL,NO,15,26,-11
0,55,2836,7,7,IND,TEN,7,7,0
0,53,2752,7,7,IND,TEN,7,7,0
1,28,2171,10,7,IND,TEN,7,7,0
1,31,1170,17,17,IND,TEN,14,17,-3
0,46,312,17,23,IND,TEN,17,17,0
1,42,3252,0,3,CIN,NYJ,0,0,0
1,24,2357,10,3,CIN,NYJ,7,3,4
1,39,1809,17,6,CIN,NYJ,3,17,-14
0,48,1571,17,6,CIN,NYJ,17,6,11
1,47,979,22,6,CIN,NYJ,19,6,13
1,25,2892,14,3,CAR,WAS,0,14,-14
1,42,2482,14,6,CAR,WAS,3,14,-11
0,49,1810,14,12,CAR,WAS,12,14,-2
1,36,1417,14,15,CAR,WAS,12,14,-2
1,30,1921,17,14,BAL,SF,14,14,0
0,51,1804,17,14,BAL,SF,14,17,-3
1,32,1121,17,17,BAL,SF,14,17,-3
1,49,3,20,17,BAL,SF,17,17,0
1,25,1860,0,23,JAX,TB,20,0,20
1,53,1251,3,23,JAX,TB,0,23,-23
1,37,143,11,26,JAX,TB,23,11,12
1,31,3154,0,3,PIT,CLE,0,0,0
1,39,1980,3,10,PIT,CLE,0,10,-10
1,29,831,20,10,PIT,CLE,17,10,7
1,34,454,20,13,PIT,CLE,10,20,-10
1,47,2527,7,17,NYG,GB,14,7,7
1,27,1955,10,17,NYG,GB,7,17,-10
1,45,1302,13,17,NYG,GB,10,17,-7
1,48,3315,0,10,MIA,PHI,7,0,7
1,43,2473,7,13,MIA,PHI,10,7,3
0,49,1176,20,28,MIA,PHI,28,20,8
1,51,222,37,28,MIA,PHI,34,28,6
1,37,115,37,31,MIA,PHI,28,37,-9
1,27,3300,0,3,ARI,LA,0,0,0
0,41,3059,0,3,ARI,LA,3,0,3
1,33,1804,0,20,ARI,LA,17,0,17
1,30,2371,14,3,DEN,LAC,0,14,-14
1,31,2136,17,3,DEN,LAC,14,3,11
0,55,560,17,17,DEN,LAC,17,17,0
1,52,271,20,17,DEN,LAC,17,17,0
1,46,19,20,20,DEN,LAC,17,20,-3
1,53,3,23,20,DEN,LAC,20,20,0
0,44,1869,21,0,KC,OAK,0,21,-21
1,50,1628,24,0,KC,OAK,21,0,21
1,34,900,31,3,KC,OAK,0,31,-31
1,23,3127,0,3,HOU,NE,0,0,0
1,29,1862,10,14,SEA,MIN,7,14,-7
1,47,1801,10,17,SEA,MIN,14,10,4
1,29,1249,20,17,SEA,MIN,17,17,0
1,36,25,37,30,SEA,MIN,34,30,4
1,36,2290,10,7,CHI,DAL,7,7,0
0,42,2105,10,7,CHI,DAL,7,10,-3
1,31,12,31,24,CHI,DAL,21,31,-10
1,37,2871,3,0,ATL,CAR,0,0,0
1,46,2696,3,3,ATL,CAR,0,3,-3
1,35,1802,13,10,ATL,CAR,10,10,0
1,29,1199,30,10,ATL,CAR,27,10,17
1,50,704,33,10,ATL,CAR,30,10,20
1,42,479,33,13,ATL,CAR,10,33,-23
1,50,3118,0,10,TB,IND,7,0,7
1,19,1803,21,27,TB,IND,24,21,3
1,44,785,31,35,TB,IND,28,35,-7
0,47,498,31,35,TB,IND,35,31,4
1,22,2890,0,3,NYJ,MIA,0,0,0
1,37,2465,9,3,NYJ,MIA,6,3,3
1,25,2144,9,6,NYJ,MIA,3,9,-6
1,28,1822,16,9,NYJ,MIA,6,16,-10
1,31,1546,16,12,NYJ,MIA,9,16,-7
0,34,1269,16,12,NYJ,MIA,12,16,-4
1,53,656,16,15,NYJ,MIA,12,16,-4
1,48,423,16,18,NYJ,MIA,15,16,-1
1,42,249,19,18,NYJ,MIA,16,18,-2
1,37,97,19,21,NYJ,MIA,18,19,-1
1,44,3,22,21,NYJ,MIA,19,21,-2
1,55,1661,30,28,NO,SF,27,28,-1
1,48,1196,33,35,NO,SF,30,35,-5
1,41,148,40,45,NO,SF,42,40,2
1,30,2,46,48,NO,SF,45,46,-1
1,27,2085,10,0,MIN,DET,7,0,7
0,45,1870,10,0,MIN,DET,0,10,-10
1,50,900,20,0,MIN,DET,17,0,17
1,54,2333,3,21,HOU,DEN,0,21,-21
1,36,1987,3,24,HOU,DEN,21,3,18
1,36,3000,0,3,BUF,BAL,0,0,0
1,36,2304,3,10,BUF,BAL,0,10,-10
1,47,1830,6,10,BUF,BAL,3,10,-7
1,48,1591,9,17,BUF,BAL,6,17,-11
1,34,3360,0,3,CLE,CIN,0,0,0
1,44,2801,7,6,CLE,CIN,3,7,-4
1,28,1183,21,16,CLE,CIN,13,21,-8
1,53,920,24,16,CLE,CIN,21,16,5
1,31,69,27,16,CLE,CIN,24,16,8
1,46,16,27,19,CLE,CIN,16,27,-11
1,32,1511,17,6,GB,WAS,14,6,8
1,52,916,17,9,GB,WAS,6,17,-11
1,33,158,20,9,GB,WAS,17,9,8
1,26,3147,3,0,JAX,LAC,0,0,0
1,40,1808,3,24,JAX,LAC,21,3,18
1,30,2964,0,3,ARI,PIT,0,0,0
1,30,2479,3,10,ARI,PIT,0,10,-10
1,37,1804,10,13,ARI,PIT,10,10,0
1,25,106,17,23,ARI,PIT,20,17,3
0,42,1804,21,21,OAK,TEN,21,21,0
1,48,3137,7,3,NE,KC,0,7,-7
0,41,2826,7,3,NE,KC,7,3,4
1,31,1862,7,20,NE,KC,17,7,10
1,41,1430,7,23,NE,KC,20,7,13
1,29,705,16,23,NE,KC,13,23,-10
1,39,3219,0,3,LA,SEA,0,0,0
0,37,1245,21,9,LA,SEA,21,9,12
1,34,427,28,12,LA,SEA,9,28,-19
1,34,2376,3,7,PHI,NYG,0,7,-7
1,34,2133,3,10,PHI,NYG,7,3,4
0,47,600,10,17,PHI,NYG,10,17,-7
0,49,3013,7,0,BAL,NYJ,0,7,-7
1,34,2718,10,7,CIN,NE,7,7,0
1,40,2035,10,10,CIN,NE,7,10,-3
1,46,1810,10,13,CIN,NE,10,10,0
1,48,398,13,27,CIN,NE,10,27,-17
1,44,2001,3,21,DET,TB,0,21,-21
1,46,1596,3,24,DET,TB,21,3,18
0,54,484,17,24,DET,TB,24,17,7
0,45,3128,0,0,TEN,HOU,0,0,0
1,29,211,14,24,TEN,HOU,21,14,7
1,23,2582,9,0,KC,DEN,6,0,6
1,24,2187,12,0,KC,DEN,9,0,9
1,32,1920,12,3,KC,DEN,0,12,-12
1,44,1802,15,3,KC,DEN,12,3,9
0,49,3344,0,0,NYG,MIA,0,0,0
1,24,1847,7,10,NYG,MIA,7,7,0
1,47,1429,14,13,NYG,MIA,10,14,-4
1,25,2786,0,3,WAS,PHI,0,0,0
1,53,486,24,24,WAS,PHI,21,24,-3
1,43,296,27,24,WAS,PHI,24,24,0
1,52,1600,10,20,CAR,SEA,7,20,-13
1,30,932,10,23,CAR,SEA,20,10,10
1,30,1908,7,3,GB,CHI,0,7,-7
1,27,900,21,6,GB,CHI,3,21,-18
1,41,2980,3,6,LAC,MIN,0,6,-6
1,26,2700,3,9,LAC,MIN,6,3,3
1,44,2062,10,12,LAC,MIN,9,10,-1
1,38,1661,10,22,LAC,MIN,19,10,9
1,27,1330,10,25,LAC,MIN,22,10,12
1,28,3192,7,3,OAK,JAX,0,7,-7
1,33,2996,10,3,OAK,JAX,7,3,4
1,34,1944,13,3,OAK,JAX,10,3,7
1,27,1802,16,3,OAK,JAX,13,3,10
1,43,932,16,6,OAK,JAX,3,16,-13
0,45,108,16,13,OAK,JAX,16,13,3
1,44,2079,14,10,ARI,CLE,7,14,-7
0,45,729,28,17,ARI,CLE,17,28,-11
1,21,321,38,17,ARI,CLE,35,17,18
1,50,1574,31,7,DAL,LA,28,7,21
1,42,900,34,7,DAL,LA,31,7,24
1,42,404,37,7,DAL,LA,34,7,27
1,43,1961,7,10,SF,ATL,7,7,0
1,22,1827,10,10,SF,ATL,7,10,-3
1,46,1220,13,10,SF,ATL,10,10,0
1,43,112,22,17,SF,ATL,19,17,2
1,49,2491,3,7,PIT,BUF,0,7,-7
1,36,747,10,10,PIT,BUF,7,10,-3
1,33,3152,3,0,NO,IND,0,0,0
1,26,1802,20,0,NO,IND,17,0,17
1,32,3394,0,10,TB,HOU,7,0,7
0,54,3212,0,10,TB,HOU,0,10,-10
1,50,2761,3,10,TB,HOU,0,10,-10
1,25,1473,17,20,TB,HOU,17,17,0
1,41,978,20,20,TB,HOU,17,20,-3
1,37,436,20,23,TB,HOU,20,20,0
1,35,3261,0,3,NE,BUF,0,0,0
1,36,2107,10,3,NE,BUF,7,3,4
1,51,1498,13,10,NE,BUF,10,10,0
1,20,648,16,17,NE,BUF,13,17,-4
1,26,3219,3,7,SF,LA,0,7,-7
0,52,1738,24,21,SF,LA,21,24,-3
1,52,156,31,31,SF,LA,28,31,-3
1,33,3,34,31,SF,LA,31,31,0
1,20,2451,14,3,MIA,CIN,0,14,-14
1,57,1807,21,6,MIA,CIN,3,21,-18
0,47,192,35,19,MIA,CIN,35,19,16
1,37,4,38,35,MIA,CIN,35,35,0
1,54,2660,10,0,NYJ,PIT,7,0,7
1,49,1882,10,3,NYJ,PIT,0,10,-10
1,37,1294,13,10,NYJ,PIT,10,10,0
1,42,195,16,10,NYJ,PIT,13,10,3
0,53,685,28,35,WAS,NYG,35,28,7
1,27,2422,14,3,IND,CAR,0,14,-14
1,35,1563,24,3,IND,CAR,21,3,18
1,50,1161,24,6,IND,CAR,3,24,-21
1,47,1109,9,21,CLE,BAL,6,21,-15
1,31,696,9,24,CLE,BAL,21,9,12
0,42,2787,14,0,ATL,JAX,14,0,14
1,40,2357,14,3,ATL,JAX,0,14,-14
1,23,1814,17,3,ATL,JAX,14,3,11
1,27,1052,17,6,ATL,JAX,3,17,-14
1,47,2621,14,3,TEN,NO,0,14,-14
1,48,514,14,24,LAC,OAK,21,14,7
1,27,93,17,24,LAC,OAK,14,24,-10
1,26,3244,0,3,DEN,DET,0,0,0
1,34,1829,10,10,DEN,DET,7,10,-3
1,26,1527,13,10,DEN,DET,10,10,0
1,22,1825,7,17,SEA,ARI,14,7,7
1,46,1600,7,20,SEA,ARI,17,7,10
0,45,980,7,20,SEA,ARI,20,7,13
1,30,900,10,20,SEA,ARI,7,20,-13
1,51,607,13,20,SEA,ARI,10,20,-10
1,36,3276,3,0,PHI,DAL,0,0,0
1,49,2580,10,3,PHI,DAL,0,10,-10
0,53,1834,10,3,PHI,DAL,10,3,7
1,32,1806,10,6,PHI,DAL,3,10,-7
0,55,662,17,6,PHI,DAL,17,6,11
1,49,484,17,9,PHI,DAL,6,17,-11
1,56,2506,0,10,CHI,KC,7,0,7
1,46,903,3,17,CHI,KC,0,17,-17
1,32,104,3,26,CHI,KC,23,3,20
1,23,3494,3,0,MIN,GB,0,0,0
1,42,2825,3,3,MIN,GB,0,3,-3
1,33,2224,10,6,MIN,GB,3,10,-7
1,19,1803,10,9,MIN,GB,6,10,-4
1,42,2218,20,10,CIN,CLE,7,20,-13
1,47,1449,23,16,CIN,CLE,20,16,4
1,46,120,33,23,CIN,CLE,30,23,7
1,27,2802,0,3,NE,MIA,0,0,0
1,25,2154,3,10,NE,MIA,0,10,-10
1,32,513,17,20,NE,MIA,17,17,0
1,26,3164,0,3,MIN,CHI,0,0,0
1,33,2748,0,6,MIN,CHI,3,0,3
1,37,2361,3,6,MIN,CHI,0,6,-6
1,34,1916,3,11,MIN,CHI,8,3,5
1,38,1802,6,11,MIN,CHI,3,11,-8
1,39,539,16,18,MIN,CHI,13,18,-5
1,34,297,19,18,MIN,CHI,16,18,-2
1,22,12,19,21,MIN,CHI,18,19,-1
1,40,2793,3,0,KC,LAC,0,0,0
0,51,3219,0,0,BUF,NYJ,0,0,0
1,30,2458,0,3,BUF,NYJ,0,0,0
0,34,1804,0,3,BUF,NYJ,3,0,3
1,28,992,3,3,BUF,NYJ,0,3,-3
1,47,129,3,13,BUF,NYJ,10,3,7
1,29,51,6,13,BUF,NYJ,3,13,-10
1,32,1824,14,3,DET,GB,0,14,-14
1,42,1803,17,3,DET,GB,14,3,11
0,51,1569,17,3,DET,GB,3,17,-14
1,40,731,17,13,DET,GB,10,17,-7
1,56,673,20,13,DET,GB,17,13,4
1,33,3,20,23,DET,GB,20,20,0
1,23,1836,3,35,CAR,NO,0,35,-35
1,27,3120,0,10,TB,ATL,7,0,7
0,49,2980,0,10,TB,ATL,0,10,-10
1,33,2124,7,13,TB,ATL,10,7,3
1,45,1862,13,16,TB,ATL,13,13,0
0,44,1591,21,16,TB,ATL,21,16,5
0,34,1166,21,16,TB,ATL,21,16,5
1,43,392,21,19,TB,ATL,16,21,-5
1,33,3,21,22,TB,ATL,19,21,-2
1,31,2923,0,3,NYG,PHI,0,0,0
1,37,2120,3,3,NYG,PHI,0,3,-3
1,50,843,17,20,NYG,PHI,17,17,0
1,28,3164,3,0,DAL,WAS,0,0,0
1,47,3018,6,0,DAL,WAS,3,0,3
1,31,2621,6,3,DAL,WAS,0,6,-6
1,42,1618,20,13,DAL,WAS,10,20,-10
1,28,1324,27,16,DAL,WAS,13,27,-14
1,48,1151,30,16,DAL,WAS,27,16,11
1,40,164,47,16,DAL,WAS,44,16,28
1,45,3181,3,0,BAL,PIT,0,0,0
1,22,2862,6,0,BAL,PIT,3,0,3
1,42,1874,9,7,BAL,PIT,6,7,-1
1,26,1498,16,10,BAL,PIT,7,16,-9
1,47,814,19,10,BAL,PIT,16,10,6
1,20,3248,0,3,JAX,IND,0,0,0
1,20,3082,3,3,JAX,IND,0,3,-3
1,53,2525,6,10,JAX,IND,3,10,-7
1,50,1844,13,20,JAX,IND,17,13,4
1,56,1802,16,20,JAX,IND,13,20,-7
0,39,3162,0,0,DEN,OAK,0,0,0
1,23,2650,0,3,DEN,OAK,0,0,0
1,43,2305,3,3,DEN,OAK,0,3,-3
1,49,1181,13,3,DEN,OAK,10,3,7
1,51,900,16,3,DEN,OAK,13,3,10
1,33,547,16,6,DEN,OAK,3,16,-13
1,28,193,16,9,DEN,OAK,6,16,-10
0,57,106,16,9,DEN,OAK,16,9,7
1,47,3257,3,0,LA,ARI,0,0,0
0,47,1865,17,7,LA,ARI,17,7,10
1,31,1807,17,10,LA,ARI,7,17,-10
1,47,3161,0,3,SEA,SF,0,0,0
1,30,2149,0,13,SEA,SF,10,0,10
